Rk,Player,Pos,Age,Tm,G,GS,MP,FG,FGA,FG%,3P,3PA,3P%,2P,2PA,2P%,eFG%,FT,FTA,FT%,ORB,DRB,TRB,AST,STL,BLK,TOV,PF,PTS
1,Alex Abrines\abrinal01,SG,25,OKC,31,2,588,56,157,.357,41,127,.323,15,30,.500,.487,12,13,.923,5,43,48,20,17,6,14,53,165
2,Quincy Acy\acyqu01,PF,28,PHO,10,0,123,4,18,.222,2,15,.133,2,3,.667,.278,7,10,.700,3,22,25,8,1,4,4,24,17
3,Jaylen Adams\adamsja01,PG,22,ATL,24,0,268,25,69,.362,20,52,.385,5,17,.294,.507,2,3,.667,8,28,36,42,6,2,16,27,72
4,Steven Adams\adamsst01,C,25,OKC,70,70,2363,426,709,.601,0,1,.000,426,708,.602,.601,137,265,.517,336,336,672,111,107,58,126,183,989
5,Bam Adebayo\adebaba01,C,21,MIA,71,18,1611,225,389,.578,1,10,.100,224,379,.591,.580,147,200,.735,141,347,488,156,58,55,105,182,598
6,Deng Adel\adelde01,SF,21,CLE,15,3,181,9,33,.273,5,21,.238,4,12,.333,.348,2,2,1.000,2,15,17,4,1,4,5,12,25
7,DeVaughn Akoon-Purcell\akoonde01,SG,25,DEN,7,0,22,3,10,.300,0,4,.000,3,6,.500,.300,1,2,.500,1,3,4,6,2,0,2,4,7
8,LaMarcus Aldridge\aldrila01,C,33,SAS,71,71,2345,590,1143,.516,9,34,.265,581,1109,.524,.520,311,364,.854,211,428,639,170,38,90,134,157,1500
9,Rawle Alkins\alkinra01,SG,21,CHI,3,0,6,1,4,.250,1,1,1.000,0,3,.000,.375,0,0,,3,0,3,2,1,0,0,1,3
10,Grayson Allen\allengr01,SG,23,UTA,32,1,300,38,117,.325,22,74,.297,16,43,.372,.419,28,40,.700,1,10,11,18,4,3,18,35,126
11,Jarrett Allen\allenja01,C,20,BRK,71,71,1887,304,516,.589,6,43,.140,298,473,.630,.595,177,246,.720,174,422,596,100,42,111,89,168,791
12,Kadeem Allen\allenka01,SG,26,NYK,13,1,296,46,96,.479,11,22,.500,35,74,.473,.536,21,28,.750,6,28,34,50,12,1,18,32,124
13,Al-Farouq Aminu\aminual01,PF,28,POR,71,71,2032,220,503,.437,88,246,.358,132,257,.514,.525,124,145,.855,99,430,529,92,62,29,64,133,652
14,Justin Anderson\anderju01,SF,25,ATL,38,0,284,36,96,.375,8,45,.178,28,51,.549,.417,16,21,.762,12,35,47,13,13,8,15,34,96
15,Kyle Anderson\anderky01,SF,25,MEM,43,40,1281,150,276,.543,9,34,.265,141,242,.583,.560,37,64,.578,48,203,251,128,54,37,58,112,346
16,Ryan Anderson\anderry01,PF,30,TOT,21,8,304,21,66,.318,9,38,.237,12,28,.429,.386,12,16,.750,16,32,48,18,3,1,14,25,63
16,Ryan Anderson\anderry01,PF,30,PHO,15,8,278,19,60,.317,7,34,.206,12,26,.462,.375,11,14,.786,14,31,45,17,3,1,12,23,56
16,Ryan Anderson\anderry01,PF,30,MIA,6,0,26,2,6,.333,2,4,.500,0,2,.000,.500,1,2,.500,2,1,3,1,0,0,2,2,7
17,Ike Anigbogu\anigbik01,C,20,IND,3,0,6,0,3,.000,0,0,,0,3,.000,.000,0,0,,1,2,3,1,0,1,1,0,0
18,Giannis Antetokounmpo\antetgi01,PF,24,MIL,65,65,2144,649,1119,.580,43,173,.249,606,946,.641,.599,444,611,.727,147,677,824,390,87,93,250,214,1785
19,Kostas Antetokounmpo\antetko01,PF,21,DAL,1,0,6,0,2,.000,0,0,,0,2,.000,.000,1,2,.500,0,1,1,0,2,0,1,0,1
20,Carmelo Anthony\anthoca01,PF,34,HOU,10,2,294,49,121,.405,21,64,.328,28,57,.491,.492,15,22,.682,9,45,54,5,4,7,8,32,134
21,OG Anunoby\anunoog01,SF,21,TOR,61,6,1245,173,379,.456,65,190,.342,108,189,.571,.542,30,56,.536,54,132,186,41,42,19,48,130,441
22,Ryan Arcidiacono\arcidry01,PG,24,CHI,72,28,1758,153,340,.450,72,193,.373,81,147,.551,.556,69,81,.852,20,165,185,242,59,4,58,151,447
23,Trevor Ariza\arizatr01,SF,33,TOT,68,68,2342,292,732,.399,144,431,.334,148,301,.492,.497,129,163,.791,50,321,371,252,91,21,106,130,857
23,Trevor Ariza\arizatr01,SF,33,PHO,26,26,884,86,227,.379,50,139,.360,36,88,.409,.489,36,43,.837,16,129,145,87,38,8,39,44,258
23,Trevor Ariza\arizatr01,SF,33,WAS,42,42,1458,206,505,.408,94,292,.322,112,213,.526,.501,93,120,.775,34,192,226,165,53,13,67,86,599
24,D.J. Augustin\augusdj01,PG,31,ORL,71,71,1966,273,576,.474,117,270,.433,156,306,.510,.576,160,185,.865,35,128,163,358,46,3,106,99,823
25,Deandre Ayton\aytonde01,C,20,PHO,66,65,2043,474,811,.584,0,4,.000,474,807,.587,.584,132,174,.759,208,472,680,122,58,61,112,193,1080
26,Dwayne Bacon\bacondw01,SG,23,CHO,31,1,419,63,131,.481,17,38,.447,46,93,.495,.546,22,29,.759,4,50,54,25,5,2,13,45,165
27,Marvin Bagley\baglema01,PF,19,SAC,51,2,1255,280,536,.522,19,69,.275,261,467,.559,.540,151,213,.709,125,239,364,52,28,48,80,100,730
28,Ron Baker\bakerro01,SG,25,TOT,15,0,152,4,20,.200,1,13,.077,3,7,.429,.225,5,6,.833,1,10,11,15,6,1,5,18,14
28,Ron Baker\bakerro01,SG,25,NYK,11,0,107,4,16,.250,1,9,.111,3,7,.429,.281,5,6,.833,1,6,7,13,5,0,3,16,14
28,Ron Baker\bakerro01,SG,25,WAS,4,0,45,0,4,.000,0,4,.000,0,0,,.000,0,0,,0,4,4,2,1,1,2,2,0
29,Wade Baldwin\baldwwa01,PG,22,POR,16,0,94,10,33,.303,2,9,.222,8,24,.333,.333,8,11,.727,2,13,15,12,1,2,14,11,30
30,Lonzo Ball\balllo01,PG,21,LAL,47,45,1423,185,456,.406,75,228,.329,110,228,.482,.488,20,48,.417,54,197,251,255,69,19,103,114,465
31,Mohamed Bamba\bambamo01,C,20,ORL,47,1,766,117,243,.481,21,70,.300,96,173,.555,.525,37,63,.587,64,169,233,39,13,64,43,102,292
32,J.J. Barea\bareajo01,PG,34,DAL,38,0,752,161,385,.418,38,128,.297,123,257,.479,.468,55,78,.705,13,82,95,211,22,1,72,50,415
33,Harrison Barnes\barneha02,PF-SF,26,TOT,65,65,2153,373,897,.416,151,390,.387,222,507,.438,.500,201,242,.831,50,261,311,95,48,12,85,105,1098
33,Harrison Barnes\barneha02,PF,26,DAL,49,49,1584,290,717,.404,121,311,.389,169,406,.416,.489,165,198,.833,36,171,207,62,33,11,68,79,866
33,Harrison Barnes\barneha02,SF,26,SAC,16,16,569,83,180,.461,30,79,.380,53,101,.525,.544,36,44,.818,14,90,104,33,15,1,17,26,232
34,Will Barton\bartowi01,SG,28,DEN,30,25,850,138,332,.416,50,141,.355,88,191,.461,.491,50,61,.820,24,123,147,98,15,17,49,59,376
35,Keita Bates-Diop\bateske01,SF,23,MIN,19,3,293,34,83,.410,6,33,.182,28,50,.560,.446,13,20,.650,10,39,49,11,7,9,7,12,87
36,Nicolas Batum\batumni01,SF,30,CHO,69,69,2221,249,548,.454,114,288,.396,135,260,.519,.558,77,89,.865,69,300,369,237,68,40,114,131,689
37,Jerryd Bayless\bayleje01,PG,30,MIN,26,6,510,62,179,.346,25,84,.298,37,95,.389,.416,7,12,.583,9,38,47,87,13,1,26,44,156
38,Aron Baynes\baynear01,C,32,BOS,43,10,634,82,179,.458,17,55,.309,65,124,.524,.506,45,54,.833,70,110,180,49,9,25,32,104,226
39,Kent Bazemore\bazemke01,SG,29,ATL,58,35,1470,252,609,.414,80,257,.311,172,352,.489,.479,120,162,.741,35,200,235,137,82,40,112,153,704
40,Bradley Beal\bealbr01,SG,25,WAS,72,72,2715,679,1429,.475,189,533,.355,490,896,.547,.541,327,399,.820,84,294,378,403,109,54,207,210,1874
41,Malik Beasley\beaslma01,SG,22,DEN,69,18,1640,306,624,.490,144,342,.421,162,282,.574,.606,44,49,.898,30,144,174,87,45,8,43,107,800
42,Michael Beasley\beaslmi01,PF,30,LAL,26,2,277,75,153,.490,3,17,.176,72,136,.529,.500,28,39,.718,13,47,60,25,9,10,27,42,181
43,Marco Belinelli\belinma01,SG,32,SAS,70,1,1620,258,614,.420,135,351,.385,123,263,.468,.530,107,118,.907,14,159,173,122,32,8,61,107,758
44,Jordan Bell\belljo01,C,24,GSW,58,2,663,78,146,.534,0,2,.000,78,144,.542,.534,22,35,.629,48,113,161,64,19,43,32,71,178
45,DeAndre' Bembry\bembrde01,SG,24,ATL,72,15,1725,235,537,.438,45,154,.292,190,383,.496,.480,65,106,.613,42,265,307,179,87,39,125,165,580
46,Dragan Bender\bendedr01,PF,21,PHO,36,17,514,54,123,.439,14,67,.209,40,56,.714,.496,17,29,.586,23,90,113,31,10,8,23,54,139
47,Dairis Bertans\bertada02,SG,29,NOP,5,0,46,4,13,.308,2,8,.250,2,5,.400,.385,0,0,,2,2,4,2,0,0,2,2,10
48,Davis Bertans\bertada01,PF,26,SAS,66,12,1428,177,387,.457,129,287,.449,48,100,.480,.624,47,54,.870,23,212,235,80,31,31,35,112,530
49,Patrick Beverley\beverpa01,PG,30,LAC,72,43,1987,176,433,.406,97,248,.391,79,185,.427,.518,94,119,.790,72,294,366,272,65,40,75,249,543
50,Khem Birch\birchkh01,C,26,ORL,40,0,491,65,108,.602,0,1,.000,65,107,.607,.602,44,58,.759,59,92,151,30,14,23,16,48,174
51,Bismack Biyombo\biyombi01,C,26,CHO,42,20,601,66,114,.579,0,0,,66,114,.579,.579,51,76,.671,62,127,189,21,8,40,24,84,183
52,Nemanja Bjelica\bjeline01,PF,30,SAC,66,59,1540,243,519,.468,93,230,.404,150,289,.519,.558,60,79,.759,108,280,388,127,48,53,78,171,639
53,Antonio Blakeney\blakean01,SG,22,CHI,51,1,699,142,334,.425,34,78,.436,108,256,.422,.476,44,65,.677,6,81,87,29,10,9,32,34,362
54,Eric Bledsoe\bledser01,PG,29,MIL,70,70,2060,424,878,.483,106,337,.315,318,541,.588,.543,158,213,.742,76,256,332,384,103,23,148,143,1112
55,Jaron Blossomgame\blossja01,SF,25,CLE,27,4,439,47,106,.443,10,39,.256,37,67,.552,.491,10,13,.769,26,72,98,13,7,8,11,20,114
56,Bogdan Bogdanovic\bogdabo01,SG,26,SAC,58,17,1625,301,727,.414,105,308,.341,196,419,.468,.486,117,141,.830,28,182,210,224,62,13,102,124,824
57,Bojan Bogdanovic\bogdabo02,SF,29,IND,72,72,2298,458,925,.495,143,341,.419,315,584,.539,.572,221,274,.807,32,263,295,136,61,0,117,128,1280
58,Andrew Bogut\bogutan01,C,34,GSW,2,2,32,4,8,.500,0,0,,4,8,.500,.500,1,1,1.000,2,11,13,4,1,0,2,6,9
59,Jonah Bolden\boldejo01,PF,23,PHI,37,6,488,60,120,.500,23,69,.333,37,51,.725,.596,10,21,.476,33,96,129,29,14,33,31,84,153
60,Isaac Bonga\bongais01,PG,19,LAL,12,0,45,2,13,.154,0,3,.000,2,10,.200,.154,6,9,.667,4,7,11,7,3,1,4,3,10
61,Devin Booker\bookede01,SG,22,PHO,57,57,2007,500,1097,.456,118,365,.323,382,732,.522,.510,334,390,.856,35,203,238,388,49,12,233,182,1452
62,Chris Boucher\bouchch01,PF,26,TOR,24,0,126,25,61,.410,10,31,.323,15,30,.500,.492,13,15,.867,14,26,40,0,6,21,3,24,73
63,Avery Bradley\bradlav01,SG,28,TOT,63,63,1905,248,608,.408,86,245,.351,162,363,.446,.479,43,50,.860,43,132,175,152,41,16,89,167,625
63,Avery Bradley\bradlav01,SG,28,LAC,49,49,1463,161,420,.383,58,172,.337,103,248,.415,.452,20,25,.800,35,96,131,96,27,16,61,133,400
63,Avery Bradley\bradlav01,SG,28,MEM,14,14,442,87,188,.463,28,73,.384,59,115,.513,.537,23,25,.920,8,36,44,56,14,0,28,34,225
64,Tony Bradley\bradlto01,C,21,UTA,1,0,9,0,3,.000,0,0,,0,3,.000,.000,0,0,,2,1,3,0,0,0,1,1,0
65,Corey Brewer\breweco01,SF,32,TOT,19,3,319,39,89,.438,9,35,.257,30,54,.556,.489,25,34,.735,8,27,35,24,20,5,12,46,112
65,Corey Brewer\breweco01,SF,32,PHI,7,3,140,20,49,.408,4,14,.286,16,35,.457,.449,9,13,.692,4,13,17,10,12,2,8,16,53
65,Corey Brewer\breweco01,SF,32,SAC,12,0,179,19,40,.475,5,21,.238,14,19,.737,.538,16,21,.762,4,14,18,14,8,3,4,30,59
66,Mikal Bridges\bridgmi01,SF,22,PHO,72,46,2049,205,472,.434,93,273,.341,112,199,.563,.533,80,101,.792,48,181,229,145,116,33,60,179,583
67,Miles Bridges\bridgmi02,SF,20,CHO,68,13,1306,178,399,.446,47,155,.303,131,244,.537,.505,50,67,.746,52,202,254,60,40,38,40,94,453
68,Isaiah Briscoe\briscis01,PG,22,ORL,39,0,559,55,138,.399,11,34,.324,44,104,.423,.438,15,26,.577,5,69,74,87,11,2,31,66,136
69,Ryan Broekhoff\broekry01,SG,28,DAL,32,0,259,31,75,.413,21,57,.368,10,18,.556,.553,2,2,1.000,4,30,34,15,3,3,7,20,85
70,Malcolm Brogdon\brogdma01,SG,26,MIL,64,64,1832,378,748,.505,104,244,.426,274,504,.544,.575,141,152,.928,65,223,288,205,46,13,91,102,1001
71,Dillon Brooks\brookdi01,SF,23,MEM,18,0,330,49,122,.402,15,40,.375,34,82,.415,.463,22,30,.733,9,22,31,16,10,4,19,50,135
72,MarShon Brooks\brookma01,SG,30,MEM,29,0,387,76,169,.450,15,54,.278,61,115,.530,.494,23,33,.697,12,33,45,25,9,4,21,33,190
73,Bruce Brown\brownbr01,SG,22,DET,62,44,1221,110,283,.389,21,84,.250,89,199,.447,.426,36,51,.706,40,124,164,75,30,32,41,153,277
74,Jaylen Brown\brownja02,SG,22,BOS,67,24,1738,333,723,.461,83,251,.331,250,472,.530,.518,117,174,.672,62,226,288,88,63,29,89,175,866
75,Lorenzo Brown\brownlo01,PG,28,TOR,26,0,212,23,71,.324,6,28,.214,17,43,.395,.366,3,3,1.000,5,26,31,28,12,5,16,22,55
76,Sterling Brown\brownst02,SG,23,MIL,48,0,769,97,213,.455,40,111,.360,57,102,.559,.549,18,25,.720,24,110,134,60,19,5,32,65,252
77,Troy Brown\browntr01,SF,19,WAS,42,0,427,55,137,.401,11,36,.306,44,101,.436,.442,23,32,.719,21,78,99,58,14,3,17,37,144
78,Jalen Brunson\brunsja01,PG,22,DAL,63,29,1314,216,462,.468,53,146,.363,163,316,.516,.525,72,94,.766,23,122,145,180,34,4,73,105,557
79,Thomas Bryant\bryanth01,C,21,WAS,62,43,1180,239,389,.614,25,72,.347,214,317,.675,.647,90,110,.818,87,265,352,72,23,56,44,99,593
80,Reggie Bullock\bullore01,SG,27,TOT,60,59,1797,232,564,.411,140,374,.374,92,190,.484,.535,71,83,.855,22,142,164,126,36,11,64,104,675
80,Reggie Bullock\bullore01,SG,27,DET,44,44,1355,182,441,.413,114,294,.388,68,147,.463,.542,56,64,.875,20,103,123,109,24,5,54,79,534
80,Reggie Bullock\bullore01,SG,27,LAL,16,15,442,50,123,.407,26,80,.325,24,43,.558,.512,15,19,.789,2,39,41,17,12,6,10,25,141
81,Trey Burke\burketr01,PG,26,TOT,47,7,892,187,441,.424,38,111,.342,149,330,.452,.467,82,99,.828,23,60,83,116,29,6,42,43,494
81,Trey Burke\burketr01,PG,26,NYK,33,7,689,148,358,.413,30,86,.349,118,272,.434,.455,62,75,.827,15,47,62,94,21,5,29,33,388
81,Trey Burke\burketr01,PG,26,DAL,14,0,203,39,83,.470,8,25,.320,31,58,.534,.518,20,24,.833,8,13,21,22,8,1,13,10,106
82,Alec Burks\burksal01,SG,27,TOT,62,24,1361,192,474,.405,61,168,.363,131,306,.428,.469,116,141,.823,29,202,231,126,38,21,65,91,561
82,Alec Burks\burksal01,SG,27,UTA,17,0,269,47,114,.412,16,43,.372,31,71,.437,.482,33,38,.868,2,25,27,20,6,4,15,22,143
82,Alec Burks\burksal01,SG,27,CLE,34,24,979,136,340,.400,45,119,.378,91,221,.412,.466,79,98,.806,26,160,186,98,25,16,46,62,396
82,Alec Burks\burksal01,SG,27,SAC,11,0,113,9,20,.450,0,6,.000,9,14,.643,.450,4,5,.800,1,17,18,8,7,1,4,7,22
83,Deonte Burton\burtode02,SG,25,OKC,27,0,229,32,77,.416,8,24,.333,24,53,.453,.468,7,10,.700,4,21,25,8,6,8,9,30,79
84,Jimmy Butler\butleji01,SF-SG,29,TOT,59,59,1994,394,838,.470,64,183,.350,330,655,.504,.508,284,332,.855,108,195,303,241,114,36,87,102,1136
84,Jimmy Butler\butleji01,SG,29,MIN,10,10,361,74,157,.471,17,45,.378,57,112,.509,.525,48,61,.787,16,36,52,43,24,10,14,18,213
84,Jimmy Butler\butleji01,SF,29,PHI,49,49,1633,320,681,.470,47,138,.341,273,543,.503,.504,236,271,.871,92,159,251,198,90,26,73,84,923
85,Bruno Caboclo\cabocbr01,SF,23,MEM,23,9,470,48,118,.407,22,74,.297,26,44,.591,.500,22,26,.846,19,64,83,29,8,20,24,56,140
86,Jose Calderon\caldejo01,PG,37,DET,48,0,628,45,119,.378,14,56,.250,31,63,.492,.437,9,11,.818,11,49,60,115,16,3,35,63,113
87,Kentavious Caldwell-Pope\caldwke01,SG,25,LAL,71,13,1657,246,566,.435,115,332,.346,131,234,.560,.536,109,126,.865,37,151,188,75,60,13,52,113,716
88,Isaiah Canaan\canaais01,PG,27,TOT,30,16,629,64,164,.390,34,96,.354,30,68,.441,.494,19,24,.792,6,52,58,84,14,2,35,52,181
88,Isaiah Canaan\canaais01,PG,27,PHO,19,15,503,51,129,.395,25,72,.347,26,57,.456,.492,15,20,.750,5,44,49,62,12,0,29,46,142
88,Isaiah Canaan\canaais01,PG,27,MIN,7,1,95,11,29,.379,7,19,.368,4,10,.400,.500,4,4,1.000,0,5,5,19,2,1,4,4,33
88,Isaiah Canaan\canaais01,PG,27,MIL,4,0,31,2,6,.333,2,5,.400,0,1,.000,.500,0,0,,1,3,4,3,0,1,2,2,6
89,Clint Capela\capelca01,C,24,HOU,57,57,1945,408,635,.643,0,0,,408,635,.643,.643,142,227,.626,259,449,708,78,39,89,83,150,958
90,DeMarre Carroll\carrode01,SF,32,BRK,59,0,1482,198,502,.394,94,268,.351,104,234,.444,.488,165,219,.753,62,249,311,78,28,8,64,93,655
91,Jevon Carter\carteje01,PG,23,MEM,28,3,409,32,118,.271,17,62,.274,15,56,.268,.343,11,16,.688,5,34,39,46,22,10,25,44,92
92,Vince Carter\cartevi01,SF,42,ATL,67,8,1144,176,402,.438,109,266,.410,67,136,.493,.573,33,49,.673,28,138,166,74,40,19,41,125,494
93,Wendell Carter\cartewe01,C,19,CHI,44,44,1110,180,371,.485,6,32,.188,174,339,.513,.493,89,112,.795,87,220,307,78,26,58,65,152,455
94,Michael Carter-Williams\cartemi01,PG,27,TOT,18,1,179,27,68,.397,7,22,.318,20,46,.435,.449,17,34,.500,4,18,22,24,9,7,12,31,78
94,Michael Carter-Williams\cartemi01,PG,27,HOU,16,1,145,25,61,.410,7,19,.368,18,42,.429,.467,12,26,.462,3,10,13,21,9,6,10,27,69
94,Michael Carter-Williams\cartemi01,PG,27,ORL,2,0,34,2,7,.286,0,3,.000,2,4,.500,.286,5,8,.625,1,8,9,3,0,1,2,4,9
95,Alex Caruso\carusal01,PG,24,LAL,14,0,197,24,49,.490,7,13,.538,17,36,.472,.561,25,31,.806,10,15,25,19,10,7,7,24,80
96,Omri Casspi\casspom01,SF,30,MEM,36,0,520,86,161,.534,15,43,.349,71,118,.602,.581,39,58,.672,17,98,115,26,20,9,23,35,226
97,Willie Cauley-Stein\caulewi01,C,25,SAC,70,70,1940,367,671,.547,1,2,.500,366,669,.547,.548,123,230,.535,163,430,593,178,85,45,78,202,858
98,Troy Caupain\caupatr01,PG,23,ORL,3,0,12,3,6,.500,2,3,.667,1,3,.333,.667,0,0,,0,2,2,3,1,0,0,0,8
99,Tyler Cavanaugh\cavanty01,PF,24,UTA,8,0,19,2,6,.333,0,3,.000,2,3,.667,.333,2,2,1.000,1,3,4,0,0,0,1,0,6
100,Tyson Chandler\chandty01,C,36,TOT,53,6,846,59,97,.608,0,1,.000,59,96,.615,.608,49,83,.590,91,206,297,37,21,22,39,108,167
100,Tyson Chandler\chandty01,C,36,PHO,7,0,89,8,12,.667,0,0,,8,12,.667,.667,10,18,.556,7,32,39,6,2,1,7,21,26
100,Tyson Chandler\chandty01,C,36,LAL,46,6,757,51,85,.600,0,1,.000,51,84,.607,.600,39,65,.600,84,174,258,31,19,21,32,87,141
101,Wilson Chandler\chandwi01,PF-SF,31,TOT,41,32,1010,95,223,.426,48,128,.375,47,95,.495,.534,13,18,.722,47,130,177,74,23,20,39,101,251
101,Wilson Chandler\chandwi01,PF,31,PHI,36,32,951,91,207,.440,46,118,.390,45,89,.506,.551,13,18,.722,44,124,168,72,22,18,39,94,241
101,Wilson Chandler\chandwi01,SF,31,LAC,5,0,59,4,16,.250,2,10,.200,2,6,.333,.313,0,0,,3,6,9,2,1,2,0,7,10
102,Joe Chealey\chealjo01,PG,23,CHO,1,0,8,1,3,.333,0,0,,1,3,.333,.333,0,0,,0,0,0,1,0,0,0,1,2
103,Marquese Chriss\chrisma01,PF,21,TOT,33,2,396,52,139,.374,15,63,.238,37,76,.487,.428,25,34,.735,30,78,108,20,11,11,31,64,144
103,Marquese Chriss\chrisma01,PF,21,HOU,16,0,104,11,34,.324,1,15,.067,10,19,.526,.338,6,7,.857,7,21,28,6,2,4,12,17,29
103,Marquese Chriss\chrisma01,PF,21,CLE,17,2,292,41,105,.390,14,48,.292,27,57,.474,.457,19,27,.704,23,57,80,14,9,7,19,47,115
104,Gary Clark\clarkga01,PF,24,HOU,44,2,589,42,123,.341,34,111,.306,8,12,.667,.480,7,7,1.000,20,84,104,17,17,25,6,43,125
105,Ian Clark\clarkia01,SG,27,NOP,52,0,727,106,264,.402,44,137,.321,62,127,.488,.485,24,27,.889,11,58,69,71,15,5,44,76,280
106,Jordan Clarkson\clarkjo01,SG,26,CLE,71,0,1927,462,1038,.445,133,402,.331,329,636,.517,.509,144,169,.852,71,171,242,167,50,13,120,103,1201
107,John Collins\collijo01,PF,21,ATL,53,51,1574,409,718,.570,47,130,.362,362,588,.616,.602,181,238,.761,192,326,518,103,18,27,105,173,1046
108,Zach Collins\colliza01,C,21,POR,66,0,1163,153,336,.455,30,100,.300,123,236,.521,.500,80,105,.762,90,186,276,62,23,55,65,158,416
109,Darren Collison\collida01,PG,31,IND,71,71,2020,287,608,.472,74,178,.416,213,430,.495,.533,151,180,.839,34,188,222,427,104,9,117,127,799
110,Bonzie Colson\colsobo01,SF,23,MIL,1,0,3,0,1,.000,0,1,.000,0,0,,.000,0,0,,0,0,0,0,0,0,0,0,0
111,Mike Conley\conlemi01,PG,31,MEM,67,67,2236,467,1070,.436,149,407,.366,318,663,.480,.506,317,374,.848,40,191,231,433,90,22,125,120,1400
112,Pat Connaughton\connapa01,SG,26,MIL,51,1,979,126,277,.455,50,160,.313,76,117,.650,.545,18,26,.692,44,143,187,99,21,22,24,66,320
113,Quinn Cook\cookqu01,PG,25,GSW,62,8,830,154,345,.446,60,157,.382,94,188,.500,.533,15,20,.750,19,112,131,90,18,3,38,70,383
114,DeMarcus Cousins\couside01,C,28,GSW,21,21,542,116,249,.466,16,65,.246,100,184,.543,.498,80,103,.777,27,138,165,76,28,32,48,77,328
115,Robert Covington\covinro01,SF,28,TOT,35,35,1203,156,362,.431,85,225,.378,71,137,.518,.548,68,89,.764,28,165,193,46,74,47,47,126,465
115,Robert Covington\covinro01,SF,28,PHI,13,13,440,50,117,.427,30,77,.390,20,40,.500,.556,17,23,.739,7,60,67,14,24,23,22,45,147
115,Robert Covington\covinro01,SF,28,MIN,22,22,763,106,245,.433,55,148,.372,51,97,.526,.545,51,66,.773,21,105,126,32,50,24,25,81,318
116,Allen Crabbe\crabbal01,SG,26,BRK,43,20,1133,137,373,.367,98,259,.378,39,114,.342,.499,41,56,.732,16,132,148,46,23,13,46,102,413
117,Torrey Craig\craigto01,SF,28,DEN,62,37,1267,135,310,.435,46,155,.297,89,155,.574,.510,37,56,.661,79,148,227,57,33,38,42,144,353
118,Jamal Crawford\crawfja01,SG,38,PHO,57,0,1006,123,341,.361,45,155,.290,78,186,.419,.427,64,77,.831,8,60,68,189,27,10,84,65,355
119,Mitch Creek\creekmi01,SF,26,BRK,4,0,36,5,10,.500,0,1,.000,5,9,.556,.500,5,7,.714,5,5,10,5,1,0,0,3,15
120,Jae Crowder\crowdja01,SF,28,UTA,70,8,1940,287,713,.403,155,466,.333,132,247,.534,.511,124,177,.701,55,285,340,117,57,26,73,151,853
121,Dante Cunningham\cunnida01,PF,31,SAS,59,21,890,74,150,.493,30,62,.484,44,88,.500,.593,14,18,.778,47,138,185,48,25,13,21,69,192
122,Seth Curry\curryse01,SG,28,POR,65,2,1144,163,367,.444,89,199,.447,74,168,.440,.565,32,38,.842,23,73,96,56,30,11,50,89,447
123,Stephen Curry\curryst01,PG,30,GSW,59,59,2029,556,1177,.472,303,706,.429,253,471,.537,.601,239,262,.912,40,272,312,309,80,21,169,147,1654
124,Troy Daniels\danietr01,SG,27,PHO,41,1,527,83,192,.432,52,136,.382,31,56,.554,.568,16,21,.762,8,39,47,21,21,4,23,57,234
125,Anthony Davis\davisan02,C,25,NOP,55,55,1829,524,1012,.518,48,144,.333,476,868,.548,.542,344,433,.794,169,493,662,217,87,134,111,132,1440
126,Deyonta Davis\davisde01,C,22,ATL,1,0,1,0,0,,0,0,,0,0,,,0,0,,0,0,0,0,0,0,0,0,0
127,Ed Davis\davised01,C,29,BRK,72,1,1299,162,268,.604,0,2,.000,162,266,.609,.604,84,140,.600,191,424,615,57,33,29,59,203,408
128,Tyler Davis\davisty01,C,21,OKC,1,0,1,0,1,.000,0,0,,0,1,.000,.000,0,0,,1,0,1,0,0,0,0,0,0
129,Dewayne Dedmon\dedmode01,C,29,ATL,60,48,1504,237,495,.479,75,203,.369,162,292,.555,.555,84,103,.816,100,349,449,86,66,66,82,202,633
130,Sam Dekker\dekkesa01,SF-PF,24,TOT,42,5,676,107,217,.493,15,47,.319,92,170,.541,.528,24,41,.585,44,89,133,40,33,7,19,39,253
130,Sam Dekker\dekkesa01,PF,24,CLE,9,5,169,22,48,.458,5,13,.385,17,35,.486,.510,8,10,.800,9,24,33,9,11,0,5,13,57
130,Sam Dekker\dekkesa01,SF,24,WAS,33,0,507,85,169,.503,10,34,.294,75,135,.556,.533,16,31,.516,35,65,100,31,22,7,14,26,196
131,Angel Delgado\delgaan01,C,24,LAC,1,0,14,1,4,.250,0,0,,1,4,.250,.250,1,2,.500,2,2,4,0,1,0,0,2,3
132,Matthew Dellavedova\dellama01,PG,28,TOT,48,0,812,98,242,.405,44,130,.338,54,112,.482,.496,42,52,.808,6,71,77,181,14,2,68,75,282
132,Matthew Dellavedova\dellama01,PG,28,MIL,12,0,97,6,19,.316,4,11,.364,2,8,.250,.421,4,4,1.000,0,10,10,29,2,0,11,9,20
132,Matthew Dellavedova\dellama01,PG,28,CLE,36,0,715,92,223,.413,40,119,.336,52,104,.500,.502,38,48,.792,6,61,67,152,12,2,57,66,262
133,Luol Deng\denglu01,SF,33,MIN,22,2,392,59,118,.500,14,44,.318,45,74,.608,.559,25,35,.714,20,53,73,18,15,8,14,24,157
134,DeMar DeRozan\derozde01,SG,29,SAS,67,67,2355,556,1169,.476,7,43,.163,549,1126,.488,.479,324,392,.827,46,375,421,410,73,32,176,151,1443
135,Marcus Derrickson\derrima01,PF,22,GSW,9,0,54,10,24,.417,5,14,.357,5,10,.500,.521,3,4,.750,5,3,8,1,0,1,3,9,28
136,Cheick Diallo\diallch01,PF,22,NOP,56,0,741,139,229,.607,0,3,.000,139,226,.615,.607,46,62,.742,62,216,278,21,26,33,41,90,324
137,Hamidou Diallo\diallha01,SG,20,OKC,48,3,524,75,165,.455,4,24,.167,71,141,.504,.467,36,59,.610,38,59,97,17,20,10,23,77,190
138,Gorgui Dieng\dienggo01,C,29,MIN,65,0,817,136,276,.493,14,46,.304,122,230,.530,.518,66,75,.880,64,188,252,54,35,33,39,112,352
139,Spencer Dinwiddie\dinwisp01,PG,25,BRK,59,4,1660,331,731,.453,114,319,.357,217,412,.527,.531,249,315,.790,23,123,146,283,35,16,135,159,1025
140,Donte DiVincenzo\divindo01,SG,22,MIL,27,0,411,50,124,.403,22,83,.265,28,41,.683,.492,9,12,.750,16,49,65,31,13,6,19,38,131
141,Luka Doncic\doncilu01,SG,19,DAL,66,66,2134,464,1080,.430,155,462,.335,309,618,.500,.501,312,441,.707,76,418,494,380,71,24,225,125,1395
142,Tyler Dorsey\dorsety01,SG,22,TOT,37,0,356,48,125,.384,20,62,.323,28,63,.444,.464,19,32,.594,14,52,66,21,9,2,15,29,135
142,Tyler Dorsey\dorsety01,SG,22,ATL,27,0,251,32,89,.360,10,39,.256,22,50,.440,.416,16,26,.615,9,34,43,17,7,1,10,20,90
142,Tyler Dorsey\dorsety01,SG,22,MEM,10,0,105,16,36,.444,10,23,.435,6,13,.462,.583,3,6,.500,5,18,23,4,2,1,5,9,45
143,Damyean Dotson\dotsoda01,SG,24,NYK,63,30,1663,257,601,.428,110,285,.386,147,316,.465,.519,65,89,.730,33,195,228,107,55,8,53,117,689
144,PJ Dozier\doziepj01,SG,22,BOS,4,0,10,3,6,.500,1,2,.500,2,4,.500,.583,0,0,,2,2,4,0,0,0,0,1,7
145,Goran Dragic\dragigo01,PG,32,MIA,25,14,645,135,305,.443,47,121,.388,88,184,.478,.520,62,78,.795,9,62,71,106,15,4,47,56,379
146,Andre Drummond\drumman01,C,25,DET,67,67,2221,478,901,.531,5,37,.135,473,864,.547,.533,204,349,.585,350,684,1034,84,108,111,144,226,1165
147,Jared Dudley\dudleja01,PF,33,BRK,51,25,1039,83,203,.409,44,129,.341,39,74,.527,.517,22,35,.629,26,104,130,70,31,13,40,115,232
148,Kris Dunn\dunnkr01,PG,24,CHI,45,43,1368,214,498,.430,34,96,.354,180,402,.448,.464,53,67,.791,18,166,184,272,67,21,104,164,515
149,Kevin Durant\duranke01,PF,30,GSW,67,67,2372,642,1252,.513,124,347,.357,518,905,.572,.562,415,470,.883,32,411,443,380,51,75,201,133,1823
150,Trevon Duval\duvaltr01,PG,20,MIL,3,0,6,2,3,.667,1,1,1.000,1,2,.500,.833,0,0,,0,1,1,2,0,0,0,0,5
151,Vince Edwards\edwarvi01,SF,22,HOU,2,0,16,1,4,.250,1,4,.250,0,0,,.375,0,0,,1,1,2,0,0,0,0,0,3
152,Henry Ellenson\ellenhe01,PF,22,TOT,12,0,165,22,60,.367,11,27,.407,11,33,.333,.458,10,13,.769,4,43,47,13,6,0,7,16,65
152,Henry Ellenson\ellenhe01,PF,22,DET,2,0,25,4,10,.400,2,4,.500,2,6,.333,.500,2,2,1.000,0,9,9,1,0,0,0,2,12
152,Henry Ellenson\ellenhe01,PF,22,NYK,10,0,140,18,50,.360,9,23,.391,9,27,.333,.450,8,11,.727,4,34,38,12,6,0,7,14,53
153,Wayne Ellington\ellinwa01,SG,31,TOT,41,26,945,127,323,.393,102,269,.379,25,54,.463,.551,23,28,.821,9,70,79,51,40,4,33,73,379
153,Wayne Ellington\ellinwa01,SG,31,MIA,25,12,533,69,184,.375,57,155,.368,12,29,.414,.530,14,16,.875,6,41,47,29,24,3,14,40,209
153,Wayne Ellington\ellinwa01,SG,31,DET,16,14,412,58,139,.417,45,114,.395,13,25,.520,.579,9,12,.750,3,29,32,22,16,1,19,33,170
154,Joel Embiid\embiijo01,C,24,PHI,59,59,1997,532,1106,.481,70,241,.290,462,865,.534,.513,487,597,.816,150,663,813,206,40,115,210,199,1621
155,James Ennis\ennisja01,SF,28,TOT,54,26,1164,132,274,.482,52,147,.354,80,127,.630,.577,53,71,.746,53,109,162,35,40,20,31,141,369
155,James Ennis\ennisja01,SF,28,HOU,40,25,949,104,211,.493,44,120,.367,60,91,.659,.597,42,58,.724,37,80,117,27,38,16,23,111,294
155,James Ennis\ennisja01,SF,28,PHI,14,1,215,28,63,.444,8,27,.296,20,36,.556,.508,11,13,.846,16,29,45,8,2,4,8,30,75
156,Drew Eubanks\eubandr01,PF,21,SAS,19,0,93,14,20,.700,0,0,,14,20,.700,.700,11,13,.846,3,22,25,6,1,4,6,10,39
157,Jacob Evans\evansja02,SG,21,GSW,26,0,120,10,30,.333,1,6,.167,9,24,.375,.350,0,1,.000,3,9,12,15,1,1,7,17,21
158,Jawun Evans\evansja01,PG,22,PHO,7,0,64,3,13,.231,0,2,.000,3,11,.273,.231,0,0,,1,11,12,10,3,0,6,8,6
159,Tyreke Evans\evansty01,SG,29,IND,60,15,1191,217,561,.387,65,190,.342,152,371,.410,.445,97,131,.740,31,135,166,145,53,15,99,100,596
160,Dante Exum\exumda01,PG,23,UTA,42,1,664,101,241,.419,18,62,.290,83,179,.464,.456,68,86,.791,16,52,68,110,14,5,52,69,288
161,Kenneth Faried\farieke01,C,29,TOT,32,13,634,135,227,.595,7,20,.350,128,207,.618,.610,59,90,.656,87,130,217,18,13,20,29,67,336
161,Kenneth Faried\farieke01,C,29,BRK,12,0,118,25,42,.595,1,5,.200,24,37,.649,.607,10,16,.625,15,29,44,2,2,4,6,8,61
161,Kenneth Faried\farieke01,C,29,HOU,20,13,516,110,185,.595,6,15,.400,104,170,.612,.611,49,74,.662,72,101,173,16,11,16,23,59,275
162,Derrick Favors\favorde01,C,27,UTA,70,64,1637,323,558,.579,17,77,.221,306,481,.636,.594,146,214,.682,188,327,515,81,52,102,76,152,809
163,Cristiano Felicio\feliccr01,C,26,CHI,51,0,545,75,137,.547,0,2,.000,75,135,.556,.547,38,54,.704,62,99,161,23,7,7,25,51,188
164,Raymond Felton\feltora01,PG,34,OKC,26,0,299,45,111,.405,12,45,.267,33,66,.500,.459,12,13,.923,4,22,26,41,8,6,13,23,114
165,Terrance Ferguson\fergute01,SG,20,OKC,64,64,1638,155,370,.419,88,247,.356,67,123,.545,.538,26,38,.684,28,86,114,56,36,15,40,206,424
166,Yogi Ferrell\ferreyo01,PG,25,SAC,59,3,850,121,279,.434,42,115,.365,79,164,.482,.509,43,49,.878,12,80,92,112,30,4,29,52,327
167,Dorian Finney-Smith\finnedo01,SF,25,DAL,71,26,1800,200,455,.440,72,219,.329,128,236,.542,.519,62,91,.681,122,220,342,81,64,36,68,165,534
168,Bryn Forbes\forbebr01,PG,25,SAS,72,71,2001,308,697,.442,148,361,.410,160,336,.476,.548,63,71,.887,16,190,206,148,41,4,73,144,827
169,Evan Fournier\fournev01,SG,26,ORL,71,71,2229,394,926,.425,138,403,.342,256,523,.489,.500,113,140,.807,37,186,223,258,63,10,140,204,1039
170,De'Aaron Fox\foxde01,PG,21,SAC,69,69,2195,436,940,.464,76,201,.378,360,739,.487,.504,266,370,.719,34,223,257,497,114,35,203,179,1214
171,Melvin Frazier\frazime01,SG,22,ORL,9,0,40,6,18,.333,0,4,.000,6,14,.429,.333,1,2,.500,3,2,5,1,1,0,1,6,13
172,Tim Frazier\fraziti01,PG,28,TOT,49,17,936,88,201,.438,27,81,.333,61,120,.508,.505,32,41,.780,32,108,140,207,25,4,61,96,235
172,Tim Frazier\fraziti01,PG,28,NOP,47,17,909,88,195,.451,27,77,.351,61,118,.517,.521,32,41,.780,32,105,137,206,25,4,60,93,235
172,Tim Frazier\fraziti01,PG,28,MIL,2,0,27,0,6,.000,0,4,.000,0,2,.000,.000,0,0,,0,3,3,1,0,0,1,3,0
173,Channing Frye\fryech01,C,35,CLE,33,5,314,37,103,.359,28,71,.394,9,32,.281,.495,9,12,.750,4,44,48,19,6,5,10,42,111
174,Markelle Fultz\fultzma01,PG,20,PHI,19,15,427,65,155,.419,4,14,.286,61,141,.433,.432,21,37,.568,26,44,70,59,17,5,25,52,155
175,Danilo Gallinari\gallida01,SF,30,LAC,60,60,1826,358,776,.461,145,331,.438,213,445,.479,.555,310,344,.901,49,310,359,147,42,21,86,115,1171
176,Langston Galloway\gallola01,SG,27,DET,68,4,1459,195,486,.401,118,319,.370,77,167,.461,.523,64,76,.842,37,106,143,72,30,6,22,112,572
177,Marc Gasol\gasolma01,C,34,TOT,69,62,2177,362,810,.447,87,251,.347,275,559,.492,.501,176,232,.759,73,491,564,306,74,77,144,191,987
177,Marc Gasol\gasolma01,C,34,MEM,53,53,1788,303,683,.444,76,221,.344,227,462,.491,.499,152,201,.756,56,399,455,248,60,63,119,147,834
177,Marc Gasol\gasolma01,C,34,TOR,16,9,389,59,127,.465,11,30,.367,48,97,.495,.508,24,31,.774,17,92,109,58,14,14,25,44,153
178,Pau Gasol\gasolpa01,C,38,TOT,30,6,360,42,94,.447,6,13,.462,36,81,.444,.479,28,40,.700,22,115,137,52,5,15,16,29,118
178,Pau Gasol\gasolpa01,C,38,SAS,27,6,330,41,88,.466,5,10,.500,36,78,.462,.494,27,38,.711,22,105,127,50,5,14,14,28,114
178,Pau Gasol\gasolpa01,C,38,MIL,3,0,30,1,6,.167,1,3,.333,0,3,.000,.250,1,2,.500,0,10,10,2,0,1,2,1,4
179,Rudy Gay\gayru01,PF,32,SAS,59,48,1591,332,651,.510,66,157,.420,266,494,.538,.561,108,130,.831,52,332,384,159,48,34,90,139,838
180,Paul George\georgpa01,SF,28,OKC,68,68,2490,622,1413,.440,256,658,.389,366,755,.485,.531,415,497,.835,91,465,556,285,150,31,183,193,1915
181,Taj Gibson\gibsota01,PF,33,MIN,70,57,1686,304,537,.566,11,34,.324,293,503,.583,.576,134,177,.757,172,286,458,84,53,39,73,186,753
182,Harry Giles\gilesha01,PF,20,SAC,57,0,812,175,348,.503,0,6,.000,175,342,.512,.503,58,91,.637,66,154,220,85,31,22,72,150,408
183,Shai Gilgeous-Alexander\gilgesh01,PG,20,LAC,72,63,1860,284,603,.471,45,120,.375,239,483,.495,.508,131,165,.794,48,149,197,224,80,39,128,152,744
184,Rudy Gobert\goberru01,C,26,UTA,71,70,2248,405,613,.661,0,0,,405,613,.661,.661,286,448,.638,273,643,916,145,58,159,114,200,1096
185,Brandon Goodwin\goodwbr01,PG,23,DEN,16,0,57,6,23,.261,2,6,.333,4,17,.235,.304,9,11,.818,1,2,3,14,0,0,3,7,23
186,Aaron Gordon\gordoaa01,PF,23,ORL,68,68,2282,410,924,.444,107,310,.345,303,614,.493,.502,169,231,.732,111,393,504,248,48,49,138,152,1096
187,Eric Gordon\gordoer01,SG,30,HOU,58,43,1880,334,826,.404,175,508,.344,159,318,.500,.510,114,146,.781,16,122,138,121,35,23,79,128,957
188,Marcin Gortat\gortama01,C,34,LAC,47,43,751,99,186,.532,0,0,,99,186,.532,.532,35,48,.729,67,194,261,65,6,24,50,92,233
189,Devonte' Graham\grahade01,PG,23,CHO,34,3,452,53,147,.361,26,86,.302,27,61,.443,.449,17,23,.739,4,38,42,72,17,2,22,35,149
190,Treveon Graham\grahatr01,SG,25,BRK,29,20,619,52,158,.329,27,103,.262,25,55,.455,.415,14,18,.778,19,72,91,29,12,7,15,63,145
191,Jerami Grant\grantje01,PF,24,OKC,70,67,2272,348,693,.502,85,227,.374,263,466,.564,.563,146,206,.709,86,287,373,70,57,91,56,185,927
192,Jerian Grant\grantje02,PG,26,ORL,56,1,923,87,210,.414,37,103,.359,50,107,.467,.502,26,38,.684,19,78,97,152,44,6,50,76,237
193,Donte Grantham\grantdo01,SF,23,OKC,3,0,2,0,2,.000,0,2,.000,0,0,,.000,0,0,,0,0,0,0,0,0,0,0,0
194,Danny Green\greenda02,SG,31,TOR,70,70,1968,251,552,.455,168,379,.443,83,173,.480,.607,32,38,.842,56,226,282,107,62,44,68,155,702
195,Draymond Green\greendr01,PF,28,GSW,55,55,1728,148,343,.431,36,136,.265,112,207,.541,.484,51,75,.680,48,359,407,388,80,59,140,177,383
196,Gerald Green\greenge01,SG,33,HOU,68,0,1410,221,552,.400,147,419,.351,74,133,.556,.534,55,66,.833,29,146,175,39,32,27,55,118,644
197,JaMychal Green\greenja01,PF,28,TOT,57,5,1209,197,409,.482,55,142,.387,142,267,.532,.549,74,94,.787,95,264,359,43,41,32,81,174,523
197,JaMychal Green\greenja01,PF,28,MEM,41,4,900,151,312,.484,38,96,.396,113,216,.523,.545,63,80,.788,72,180,252,36,33,26,64,123,403
197,JaMychal Green\greenja01,PF,28,LAC,16,1,309,46,97,.474,17,46,.370,29,51,.569,.562,11,14,.786,23,84,107,7,8,6,17,51,120
198,Jeff Green\greenje02,PF,32,WAS,70,44,1958,298,627,.475,106,295,.359,192,332,.578,.560,166,187,.888,53,236,289,132,37,35,93,150,868
199,Blake Griffin\griffbl01,PF,29,DET,67,67,2366,561,1199,.468,165,454,.363,396,745,.532,.537,371,498,.745,89,423,512,362,45,26,238,181,1658
200,Daniel Hamilton\hamilda02,SG,23,ATL,19,3,204,23,60,.383,8,23,.348,15,37,.405,.450,3,6,.500,10,37,47,22,6,1,16,19,57
201,Tim Hardaway\hardati02,SG,26,TOT,65,63,2057,390,993,.393,162,477,.340,228,516,.442,.474,232,276,.841,33,189,222,159,54,8,105,141,1174
201,Tim Hardaway\hardati02,SG,26,NYK,46,46,1499,282,726,.388,117,337,.347,165,389,.424,.469,199,233,.854,26,135,161,122,42,6,81,106,880
201,Tim Hardaway\hardati02,SG,26,DAL,19,17,558,108,267,.404,45,140,.321,63,127,.496,.489,33,43,.767,7,54,61,37,12,2,24,35,294
202,James Harden\hardeja01,SG,29,HOU,68,68,2538,732,1680,.436,325,907,.358,407,773,.527,.532,667,759,.879,58,381,439,521,148,52,346,219,2456
203,Maurice Harkless\harklma01,SF,25,POR,50,43,1138,148,302,.490,28,97,.289,120,205,.585,.536,34,52,.654,59,153,212,55,55,42,35,133,358
204,Montrezl Harrell\harremo01,C,25,LAC,72,4,1903,478,780,.613,2,14,.143,476,766,.621,.614,229,362,.633,170,316,486,134,64,99,111,229,1187
205,Devin Harris\harride01,PG,35,DAL,58,0,878,110,284,.387,49,160,.306,61,124,.492,.474,85,113,.752,9,79,88,91,34,12,47,109,354
206,Gary Harris\harriga01,SG,24,DEN,44,35,1261,215,506,.425,66,196,.337,149,310,.481,.490,100,124,.806,32,96,128,110,40,17,53,89,596
207,Joe Harris\harrijo01,SG,27,BRK,68,68,2017,328,656,.500,156,336,.464,172,320,.538,.619,96,115,.835,45,201,246,165,35,16,110,165,908
208,Tobias Harris\harrito02,PF-SF,26,TOT,73,73,2549,557,1121,.497,148,355,.417,409,766,.534,.563,242,277,.874,55,523,578,201,49,34,137,163,1504
208,Tobias Harris\harrito02,PF,26,LAC,55,55,1903,424,855,.496,112,258,.434,312,597,.523,.561,192,219,.877,37,395,432,150,40,24,109,123,1152
208,Tobias Harris\harrito02,SF,26,PHI,18,18,646,133,266,.500,36,97,.371,97,169,.574,.568,50,58,.862,18,128,146,51,9,10,28,40,352
209,Andrew Harrison\harrian01,SG-PG,24,TOT,17,0,187,16,53,.302,5,25,.200,11,28,.393,.349,17,18,.944,6,14,20,24,4,2,12,34,54
209,Andrew Harrison\harrian01,PG,24,MEM,1,0,5,1,2,.500,0,1,.000,1,1,1.000,.500,0,0,,0,0,0,0,0,0,0,1,2
209,Andrew Harrison\harrian01,SG,24,CLE,10,0,144,12,39,.308,3,14,.214,9,25,.360,.346,16,16,1.000,4,11,15,17,4,2,10,26,43
209,Andrew Harrison\harrian01,SG,24,NOP,6,0,38,3,12,.250,2,10,.200,1,2,.500,.333,1,2,.500,2,3,5,7,0,0,2,7,9
210,Shaquille Harrison\harrish01,PG,25,CHI,64,2,1162,137,321,.427,19,73,.260,118,248,.476,.456,71,107,.664,23,143,166,117,77,21,50,106,364
211,Josh Hart\hartjo01,SG,23,LAL,67,22,1715,189,464,.407,92,274,.336,97,190,.511,.506,55,80,.688,35,213,248,93,64,40,58,147,525
212,Isaiah Hartenstein\harteis01,PF,20,HOU,27,0,220,20,41,.488,2,6,.333,18,35,.514,.512,11,14,.786,21,26,47,14,7,12,13,56,53
213,Udonis Haslem\hasleud01,C,38,MIA,8,0,35,3,9,.333,0,4,.000,3,5,.600,.333,0,0,,1,11,12,0,0,0,2,4,6
214,Gordon Hayward\haywago01,PF,28,BOS,64,17,1624,248,553,.448,71,212,.335,177,341,.519,.513,127,154,.825,48,226,274,220,56,21,93,91,694
215,John Henson\hensojo01,C,28,MIL,14,0,188,31,67,.463,11,31,.355,20,36,.556,.545,6,10,.600,16,55,71,14,7,11,12,16,79
216,Juan Hernangomez\hernaju01,PF,23,DEN,63,25,1279,135,301,.449,65,173,.376,70,128,.547,.556,64,84,.762,62,194,256,50,25,24,36,86,399
217,Willy Hernangomez\hernawi01,C,24,CHO,48,3,655,125,240,.521,13,30,.433,112,210,.533,.548,76,112,.679,93,166,259,46,12,16,47,84,339
218,Mario Hezonja\hezonma01,SF,23,NYK,51,17,1006,155,384,.404,38,129,.295,117,255,.459,.453,67,90,.744,23,169,192,54,49,7,64,92,415
219,Isaiah Hicks\hicksis01,PF,24,NYK,1,0,4,0,0,,0,0,,0,0,,,1,2,.500,0,0,0,1,0,0,0,0,1
220,Buddy Hield\hieldbu01,SG,26,SAC,70,70,2243,535,1161,.461,231,540,.428,304,621,.490,.560,150,171,.877,97,265,362,171,47,28,134,174,1451
221,Haywood Highsmith\highsha01,SF,22,PHI,2,0,9,1,2,.500,1,2,.500,0,0,,.750,0,0,,0,1,1,2,0,0,0,0,3
222,Nene Hilario\hilarne01,C,36,HOU,37,2,482,53,99,.535,0,2,.000,53,97,.546,.535,27,40,.675,28,82,110,22,18,14,10,75,133
223,George Hill\hillge01,PG,32,TOT,50,13,1073,128,291,.440,37,118,.314,91,173,.526,.503,47,57,.825,31,88,119,112,44,7,40,83,340
223,George Hill\hillge01,PG,32,CLE,13,13,344,55,107,.514,13,28,.464,42,79,.532,.575,17,20,.850,12,15,27,36,12,1,20,35,140
223,George Hill\hillge01,PG,32,MIL,37,0,729,73,184,.397,24,90,.267,49,94,.521,.462,30,37,.811,19,73,92,76,32,6,20,48,200
224,Solomon Hill\hillso01,SF,27,NOP,38,15,746,52,137,.380,22,75,.293,30,62,.484,.460,19,27,.704,32,82,114,46,22,9,25,65,145
225,Aaron Holiday\holidaa01,PG,22,IND,43,0,486,80,209,.383,31,102,.304,49,107,.458,.457,32,37,.865,4,52,56,60,17,12,29,51,223
226,Jrue Holiday\holidjr01,SG,28,NOP,67,67,2402,547,1159,.472,118,363,.325,429,796,.539,.523,208,271,.768,75,259,334,518,109,54,210,148,1420
227,Justin Holiday\holidju01,SG,29,TOT,71,66,2230,240,646,.372,130,388,.335,110,258,.426,.472,78,87,.897,37,245,282,130,101,32,87,140,688
227,Justin Holiday\holidju01,SG,29,CHI,38,38,1325,151,394,.383,97,270,.359,54,124,.435,.506,41,46,.891,19,150,169,85,67,21,47,79,440
227,Justin Holiday\holidju01,SG,29,MEM,33,28,905,89,252,.353,33,118,.280,56,134,.418,.419,37,41,.902,18,95,113,45,34,11,40,61,248
228,John Holland\hollajo02,SF,30,CLE,1,0,1,0,0,,0,0,,0,0,,,0,0,,0,0,0,0,0,0,0,0,0
229,Rondae Hollis-Jefferson\holliro01,SF,24,BRK,56,21,1173,186,450,.413,9,47,.191,177,403,.439,.423,113,174,.649,73,209,282,91,39,26,61,102,494
230,Richaun Holmes\holmeri01,C,25,PHO,64,2,1050,201,323,.622,0,0,,201,323,.622,.622,108,150,.720,104,191,295,51,38,72,47,175,510
231,Rodney Hood\hoodro01,SG,26,TOT,62,46,1614,248,572,.434,74,204,.363,174,368,.473,.498,127,142,.894,21,116,137,106,50,9,44,130,697
231,Rodney Hood\hoodro01,SG,26,CLE,45,45,1234,194,454,.427,55,152,.362,139,302,.460,.488,104,114,.912,18,94,112,92,38,5,36,101,547
231,Rodney Hood\hoodro01,SG,26,POR,17,1,380,54,118,.458,19,52,.365,35,66,.530,.538,23,28,.821,3,22,25,14,12,4,8,29,150
232,Al Horford\horfoal01,C,32,BOS,62,62,1790,343,649,.529,69,193,.358,274,456,.601,.582,63,78,.808,110,303,413,253,54,80,94,120,818
233,Danuel House\houseda01,SF,25,HOU,29,13,755,91,193,.472,54,130,.415,37,63,.587,.611,50,63,.794,25,80,105,30,15,10,31,57,286
234,Dwight Howard\howardw01,C,33,WAS,9,9,230,43,69,.623,0,0,,43,69,.623,.623,29,48,.604,24,59,83,4,7,4,16,34,115
235,Kevin Huerter\huertke01,SG,20,ATL,66,50,1790,233,562,.415,118,309,.382,115,253,.455,.520,40,54,.741,51,167,218,181,57,22,99,133,624
236,Chandler Hutchison\hutchch01,SF,22,CHI,44,14,895,96,209,.459,14,50,.280,82,159,.516,.493,23,38,.605,31,154,185,34,23,6,25,59,229
237,Serge Ibaka\ibakase01,C,29,TOR,65,50,1813,402,772,.521,40,152,.263,362,620,.584,.547,128,165,.776,138,391,529,92,28,90,101,189,972
238,Andre Iguodala\iguodan01,SF,35,GSW,61,13,1440,135,271,.498,45,131,.344,90,140,.643,.581,38,64,.594,42,192,234,199,54,48,43,90,353
239,Ersan Ilyasova\ilyaser01,PF,31,MIL,58,6,1037,149,333,.447,51,137,.372,98,196,.500,.524,51,61,.836,90,170,260,47,30,17,41,148,400
240,Joe Ingles\inglejo01,SF,31,UTA,71,71,2234,303,690,.439,154,410,.376,149,280,.532,.551,79,111,.712,30,251,281,384,90,20,167,164,839
241,Andre Ingram\ingraan01,SG,33,LAL,4,0,15,0,6,.000,0,3,.000,0,3,.000,.000,0,0,,1,1,2,0,1,0,1,0,0
242,Brandon Ingram\ingrabr01,SF,21,LAL,52,52,1760,362,729,.497,31,94,.330,331,635,.521,.518,195,289,.675,41,226,267,154,28,31,129,149,950
243,Kyrie Irving\irvinky01,PG,26,BOS,60,60,1983,545,1108,.492,153,381,.402,392,727,.539,.561,193,222,.869,69,238,307,422,92,32,156,143,1436
244,Jonathan Isaac\isaacjo01,PF,21,ORL,66,55,1759,225,527,.427,68,218,.312,157,309,.508,.491,102,124,.823,83,274,357,69,49,87,67,127,620
245,Wesley Iwundu\iwundwe01,SF,24,ORL,58,12,1053,92,234,.393,21,64,.328,71,170,.418,.438,77,96,.802,32,129,161,59,26,20,41,109,282
246,Demetrius Jackson\jacksde01,PG,24,PHI,6,0,39,8,15,.533,2,6,.333,6,9,.667,.600,4,4,1.000,2,1,3,5,2,0,1,4,22
247,Frank Jackson\jacksfr01,PG,20,NOP,59,14,1109,182,421,.432,48,157,.306,134,264,.508,.489,44,61,.721,24,105,129,63,23,2,45,90,456
248,Jaren Jackson\jacksja02,PF,19,MEM,58,56,1515,298,589,.506,51,142,.359,247,447,.553,.549,151,197,.766,73,199,272,64,52,82,98,220,798
249,Josh Jackson\jacksjo02,SG,21,PHO,72,25,1747,304,739,.411,62,193,.321,242,546,.443,.453,132,196,.673,61,240,301,162,68,48,163,184,802
250,Justin Jackson\jacksju01,SF,23,TOT,70,3,1329,161,381,.423,70,201,.348,91,180,.506,.514,51,64,.797,34,142,176,76,27,14,25,83,443
250,Justin Jackson\jacksju01,SF,23,SAC,52,3,1083,125,295,.424,55,159,.346,70,136,.515,.517,41,50,.820,25,121,146,68,23,13,22,67,346
250,Justin Jackson\jacksju01,SF,23,DAL,18,0,246,36,86,.419,15,42,.357,21,44,.477,.506,10,14,.714,9,21,30,8,4,1,3,16,97
251,Reggie Jackson\jacksre01,PG,28,DET,70,70,1982,373,879,.424,148,398,.372,225,481,.468,.509,181,208,.870,37,143,180,298,48,7,121,182,1075
252,LeBron James\jamesle01,SF,34,LAL,51,51,1800,519,1009,.514,102,301,.339,417,708,.589,.565,261,393,.664,52,383,435,406,68,31,176,88,1401
253,Amile Jefferson\jeffeam01,PF,25,ORL,7,0,27,2,6,.333,0,0,,2,6,.333,.333,4,4,1.000,3,7,10,0,1,1,0,4,8
254,John Jenkins\jenkijo01,SG,27,TOT,17,0,174,22,58,.379,10,28,.357,12,30,.400,.466,7,9,.778,2,13,15,9,0,1,5,1,61
254,John Jenkins\jenkijo01,SG,27,WAS,4,0,14,2,2,1.000,2,2,1.000,0,0,,1.500,0,0,,0,1,1,1,0,0,0,0,6
254,John Jenkins\jenkijo01,SG,27,NYK,13,0,160,20,56,.357,8,26,.308,12,30,.400,.429,7,9,.778,2,12,14,8,0,1,5,1,55
255,Jonas Jerebko\jerebjo01,PF,31,GSW,62,6,1068,143,308,.464,58,161,.360,85,147,.578,.558,59,71,.831,67,200,267,83,18,13,37,118,403
256,Alize Johnson\johnsal02,PF,22,IND,11,0,32,2,10,.200,1,2,.500,1,8,.125,.250,1,4,.250,1,7,8,0,0,1,0,3,6
257,Amir Johnson\johnsam01,C,31,PHI,44,6,459,69,136,.507,11,34,.324,58,102,.569,.548,27,36,.750,38,86,124,53,15,11,44,91,176
258,B.J. Johnson\johnsbj01,SF,23,ATL,6,0,43,8,16,.500,3,6,.500,5,10,.500,.594,2,2,1.000,2,6,8,0,2,0,2,3,21
259,James Johnson\johnsja01,PF,31,MIA,44,33,920,136,309,.440,43,118,.364,93,191,.487,.510,38,51,.745,17,124,141,104,32,22,56,90,353
260,Stanley Johnson\johnsst04,SF,22,TOT,61,7,1106,150,402,.373,55,202,.272,95,200,.475,.442,47,61,.770,34,170,204,78,56,13,69,105,402
260,Stanley Johnson\johnsst04,SF,22,DET,48,7,961,133,349,.381,51,181,.282,82,168,.488,.454,41,51,.804,25,150,175,60,48,13,55,92,358
260,Stanley Johnson\johnsst04,SF,22,NOP,13,0,145,17,53,.321,4,21,.190,13,32,.406,.358,6,10,.600,9,20,29,18,8,0,14,13,44
261,Tyler Johnson\johnsty01,PG-SG,26,TOT,57,22,1529,217,526,.413,90,260,.346,127,266,.477,.498,95,127,.748,34,139,173,166,54,27,77,97,619
261,Tyler Johnson\johnsty01,PG,26,MIA,44,10,1123,171,401,.426,72,204,.353,99,197,.503,.516,61,88,.693,19,102,121,112,40,21,63,72,475
261,Tyler Johnson\johnsty01,SG,26,PHO,13,12,406,46,125,.368,18,56,.321,28,69,.406,.440,34,39,.872,15,37,52,54,14,6,14,25,144
262,Wesley Johnson\johnswe01,SF,31,TOT,36,13,521,45,125,.360,25,76,.329,20,49,.408,.460,10,16,.625,12,58,70,23,14,11,18,60,125
262,Wesley Johnson\johnswe01,SF,31,NOP,26,13,377,35,88,.398,19,50,.380,16,38,.421,.506,6,9,.667,10,44,54,16,12,7,12,45,95
262,Wesley Johnson\johnswe01,SF,31,WAS,10,0,144,10,37,.270,6,26,.231,4,11,.364,.351,4,7,.571,2,14,16,7,2,4,6,15,30
263,Nikola Jokic\jokicni01,C,23,DEN,68,68,2143,520,1022,.509,76,235,.323,444,787,.564,.546,265,317,.836,198,532,730,513,94,46,218,193,1381
264,Damian Jones\jonesda03,C,23,GSW,24,22,410,53,74,.716,0,0,,53,74,.716,.716,24,37,.649,31,44,75,28,12,25,16,63,130
265,Derrick Jones\jonesde02,SF,21,MIA,51,8,964,140,284,.493,26,78,.333,114,206,.553,.539,60,100,.600,86,120,206,29,40,38,39,106,366
266,Jalen Jones\jonesja04,SF,25,CLE,16,0,214,26,62,.419,10,28,.357,16,34,.471,.500,19,27,.704,11,23,34,7,9,2,8,27,81
267,Terrence Jones\joneste01,PF,27,HOU,2,0,5,1,4,.250,0,2,.000,1,2,.500,.250,0,1,.000,0,4,4,0,0,0,1,1,2
268,Tyus Jones\jonesty01,PG,22,MIN,57,12,1216,132,336,.393,29,99,.293,103,237,.435,.436,45,55,.818,19,90,109,242,70,5,37,63,338
269,DeAndre Jordan\jordade01,C,30,TOT,66,66,1971,276,429,.643,0,0,,276,429,.643,.643,176,250,.704,218,653,871,148,40,70,146,162,728
269,DeAndre Jordan\jordade01,C,30,DAL,50,50,1554,208,323,.644,0,0,,208,323,.644,.644,135,198,.682,161,525,686,99,33,53,111,125,551
269,DeAndre Jordan\jordade01,C,30,NYK,16,16,417,68,106,.642,0,0,,68,106,.642,.642,41,52,.788,57,128,185,49,7,17,35,37,177
270,Cory Joseph\josepco01,PG,27,IND,72,4,1818,207,484,.428,52,154,.338,155,330,.470,.481,26,39,.667,34,218,252,278,79,19,73,115,492
271,Frank Kaminsky\kaminfr01,C,25,CHO,35,0,493,91,191,.476,30,85,.353,61,106,.575,.555,47,67,.701,30,77,107,39,5,7,32,46,259
272,Enes Kanter\kanteen01,C,26,TOT,57,23,1367,302,562,.537,7,28,.250,295,534,.552,.544,137,169,.811,207,344,551,104,24,21,100,137,748
272,Enes Kanter\kanteen01,C,26,NYK,44,23,1128,251,468,.536,7,22,.318,244,446,.547,.544,105,129,.814,171,290,461,84,18,17,79,106,614
272,Enes Kanter\kanteen01,C,26,POR,13,0,239,51,94,.543,0,6,.000,51,88,.580,.543,32,40,.800,36,54,90,20,6,4,21,31,134
273,Luke Kennard\kennalu01,SG,22,DET,52,10,1166,183,422,.434,84,218,.385,99,204,.485,.533,38,48,.792,10,140,150,92,21,10,44,76,488
274,Michael Kidd-Gilchrist\kiddgmi01,PF,25,CHO,58,1,1093,150,311,.482,12,41,.293,138,270,.511,.502,93,121,.769,86,147,233,52,28,38,41,145,405
275,George King\kingge03,SF,25,PHO,1,0,6,0,0,,0,0,,0,0,,,0,0,,0,1,1,0,0,0,0,0,0
276,Maxi Kleber\klebima01,PF,27,DAL,62,16,1275,151,335,.451,63,187,.337,88,148,.595,.545,53,66,.803,78,192,270,60,32,72,46,121,418
277,Brandon Knight\knighbr03,PG,27,TOT,29,16,476,68,175,.389,30,94,.319,38,81,.469,.474,20,25,.800,6,33,39,52,14,1,15,41,186
277,Brandon Knight\knighbr03,PG,27,HOU,12,0,118,11,47,.234,5,32,.156,6,15,.400,.287,9,11,.818,1,8,9,9,2,0,5,14,36
277,Brandon Knight\knighbr03,PG,27,CLE,17,16,358,57,128,.445,25,62,.403,32,66,.485,.543,11,14,.786,5,25,30,43,12,1,10,27,150
278,Kevin Knox\knoxke01,PF,19,NYK,65,47,1839,287,779,.368,105,303,.347,182,476,.382,.436,134,182,.736,54,231,285,68,37,19,95,157,813
279,Furkan Korkmaz\korkmfu01,SG,21,PHI,46,6,654,94,234,.402,46,139,.331,48,95,.505,.500,35,42,.833,16,89,105,51,28,2,25,59,269
280,Luke Kornet\kornelu01,PF,23,NYK,37,13,571,75,209,.359,51,143,.357,24,66,.364,.481,30,37,.811,20,71,91,39,23,23,19,31,231
281,Kyle Korver\korveky01,SG-PF,37,TOT,65,0,1246,192,450,.427,131,324,.404,61,126,.484,.572,57,67,.851,8,138,146,70,23,12,55,100,572
281,Kyle Korver\korveky01,PF,37,CLE,16,0,251,35,76,.461,25,54,.463,10,22,.455,.625,13,16,.813,0,29,29,17,3,2,17,22,108
281,Kyle Korver\korveky01,SG,37,UTA,49,0,995,157,374,.420,106,270,.393,51,104,.490,.561,44,51,.863,8,109,117,53,20,10,38,78,464
282,Kosta Koufos\koufoko01,C,29,SAC,33,1,388,56,116,.483,0,0,,56,116,.483,.483,6,17,.353,42,101,143,26,14,14,20,56,118
283,Rodions Kurucs\kurucro01,SF,20,BRK,54,37,1118,181,382,.474,50,149,.336,131,233,.562,.539,67,81,.827,48,154,202,43,38,23,69,129,479
284,Kyle Kuzma\kuzmaky01,PF,23,LAL,65,63,2147,459,997,.460,115,378,.304,344,619,.556,.518,172,232,.741,58,304,362,175,40,22,126,155,1205
285,Skal Labissiere\labissk01,PF,22,TOT,18,0,124,13,30,.433,4,11,.364,9,19,.474,.500,6,13,.462,4,21,25,6,2,4,9,22,36
285,Skal Labissiere\labissk01,PF,22,SAC,13,0,113,13,30,.433,4,11,.364,9,19,.474,.500,6,11,.545,4,20,24,6,2,3,7,21,36
285,Skal Labissiere\labissk01,PF,22,POR,5,0,11,0,0,,0,0,,0,0,,,0,2,.000,0,1,1,0,0,1,2,1,0
286,Jeremy Lamb\lambje01,SG,26,CHO,67,55,1933,369,835,.442,97,283,.343,272,552,.493,.500,196,222,.883,53,326,379,147,71,26,73,127,1031
287,Zach LaVine\lavinza01,SG,23,CHI,63,62,2171,530,1135,.467,120,321,.374,410,814,.504,.520,312,375,.832,40,254,294,283,60,26,215,140,1492
288,Jake Layman\laymaja01,SF,24,POR,60,27,1119,185,362,.511,53,159,.333,132,203,.650,.584,34,47,.723,52,143,195,44,25,29,41,96,457
289,T.J. Leaf\leaftj01,PF,21,IND,49,0,417,74,137,.540,6,26,.231,68,111,.613,.562,13,21,.619,29,68,97,19,5,13,10,31,167
290,Courtney Lee\leeco01,SG,33,TOT,25,2,295,33,81,.407,9,33,.273,24,48,.500,.463,13,19,.684,7,28,35,24,15,3,8,23,88
290,Courtney Lee\leeco01,SG,33,NYK,12,2,160,21,47,.447,5,16,.313,16,31,.516,.500,9,14,.643,6,21,27,16,8,2,5,13,56
290,Courtney Lee\leeco01,SG,33,DAL,13,0,135,12,34,.353,4,17,.235,8,17,.471,.412,4,5,.800,1,7,8,8,7,1,3,10,32
291,Damion Lee\leeda03,SG,26,GSW,26,0,282,39,90,.433,19,50,.380,20,40,.500,.539,12,15,.800,7,36,43,5,10,0,10,26,109
292,Alex Len\lenal01,C,25,ATL,68,25,1322,262,536,.489,50,149,.336,212,387,.548,.535,124,186,.667,138,233,371,69,23,61,89,173,698
293,Kawhi Leonard\leonaka01,SF,27,TOR,52,52,1794,491,990,.496,97,262,.370,394,728,.541,.545,326,382,.853,70,318,388,170,95,21,107,76,1405
294,Meyers Leonard\leoname01,C,26,POR,55,1,781,117,217,.539,48,103,.466,69,114,.605,.650,36,44,.818,42,164,206,65,13,9,38,93,318
295,Jon Leuer\leuerjo01,PF,29,DET,36,1,379,64,109,.587,1,10,.100,63,99,.636,.592,23,31,.742,25,69,94,14,12,4,23,57,152
296,Caris LeVert\leverca01,SF,24,BRK,31,24,832,162,385,.421,34,120,.283,128,265,.483,.465,61,86,.709,25,98,123,119,32,11,58,62,419
297,Damian Lillard\lillada01,PG,28,POR,70,70,2481,606,1341,.452,206,553,.373,400,788,.508,.529,421,462,.911,59,257,316,470,82,31,188,134,1839
298,Jeremy Lin\linje01,PG,30,TOT,65,4,1289,223,496,.450,51,172,.297,172,324,.531,.501,164,196,.837,20,135,155,213,44,11,118,128,661
298,Jeremy Lin\linje01,PG,30,ATL,51,1,1003,180,386,.466,44,132,.333,136,254,.535,.523,142,168,.845,16,103,119,181,38,7,98,96,546
298,Jeremy Lin\linje01,PG,30,TOR,14,3,286,43,110,.391,7,40,.175,36,70,.514,.423,22,28,.786,4,32,36,32,6,4,20,32,115
299,Shaun Livingston\livinsh01,PG,33,GSW,55,0,845,93,191,.487,0,2,.000,93,189,.492,.487,40,48,.833,38,62,100,102,28,24,36,63,226
300,Zach Lofton\loftoza01,SG,26,DET,1,0,4,0,1,.000,0,1,.000,0,0,,.000,0,0,,0,0,0,0,1,0,1,0,0
301,Kevon Looney\looneke01,C,22,GSW,68,24,1333,180,291,.619,1,10,.100,179,281,.637,.620,58,97,.598,172,206,378,112,39,49,47,190,419
302,Brook Lopez\lopezbr01,C,30,MIL,72,72,2059,319,701,.455,170,461,.369,149,240,.621,.576,95,112,.848,29,306,335,82,46,163,74,167,903
303,Robin Lopez\lopezro01,C,30,CHI,65,27,1370,255,447,.570,6,23,.261,249,424,.587,.577,78,106,.736,118,128,246,72,11,72,85,117,594
304,Kevin Love\loveke01,PF,30,CLE,17,17,457,81,218,.372,42,117,.359,39,101,.386,.468,95,105,.905,27,162,189,37,4,4,32,45,299
305,Kyle Lowry\lowryky01,PG,32,TOR,57,57,1971,278,667,.417,143,405,.353,135,262,.515,.524,146,176,.830,37,235,272,515,77,29,164,149,845
306,Jordan Loyd\loydjo01,PG,25,TOR,9,0,37,5,12,.417,2,6,.333,3,6,.500,.500,4,5,.800,1,6,7,2,0,0,2,5,16
307,Kalin Lucas\lucaska01,PG,29,DET,1,0,6,0,1,.000,0,1,.000,0,0,,.000,2,2,1.000,0,3,3,1,0,0,0,1,2
308,Timothe Luwawu-Cabarrot\luwawti01,SF-SG,23,TOT,41,3,434,48,135,.356,23,72,.319,25,63,.397,.441,14,21,.667,9,50,59,16,15,4,13,47,133
308,Timothe Luwawu-Cabarrot\luwawti01,SF,23,OKC,21,1,123,13,43,.302,5,22,.227,8,21,.381,.360,4,6,.667,4,14,18,4,4,1,5,14,35
308,Timothe Luwawu-Cabarrot\luwawti01,SG,23,CHI,20,2,311,35,92,.380,18,50,.360,17,42,.405,.478,10,15,.667,5,36,41,12,11,3,8,33,98
309,Tyler Lydon\lydonty01,PF,22,DEN,24,0,90,8,17,.471,4,10,.400,4,7,.571,.588,1,3,.333,6,11,17,5,2,0,4,10,21
310,Trey Lyles\lylestr01,PF,23,DEN,56,1,1024,193,456,.423,46,181,.254,147,275,.535,.474,75,108,.694,41,182,223,77,28,23,61,85,507
311,Shelvin Mack\macksh01,PG,28,TOT,56,3,1236,162,399,.406,46,130,.354,116,269,.431,.464,57,82,.695,18,86,104,183,47,4,64,84,427
311,Shelvin Mack\macksh01,PG,28,MEM,53,3,1204,161,389,.414,46,128,.359,115,261,.441,.473,53,75,.707,18,84,102,182,45,4,62,81,421
311,Shelvin Mack\macksh01,PG,28,CHO,3,0,32,1,10,.100,0,2,.000,1,8,.125,.100,4,7,.571,0,2,2,1,2,0,2,3,6
312,Daryl Macon\maconda01,SG,23,DAL,4,0,8,2,2,1.000,0,0,,2,2,1.000,1.000,0,0,,0,0,0,0,1,0,1,0,4
313,J.P. Macura\macurjp01,SG,23,CHO,1,0,14,2,8,.250,0,4,.000,2,4,.500,.250,0,0,,0,2,2,2,0,0,0,0,4
314,Ian Mahinmi\mahinia01,C,32,WAS,32,6,453,42,86,.488,1,13,.077,41,73,.562,.494,41,60,.683,40,69,109,24,24,15,20,76,126
315,Thon Maker\makerth01,C-PF,21,TOT,52,1,705,87,212,.410,37,118,.314,50,94,.532,.498,38,64,.594,34,121,155,36,16,35,24,82,249
315,Thon Maker\makerth01,C,21,MIL,35,0,409,59,134,.440,26,78,.333,33,56,.589,.537,20,37,.541,17,79,96,18,10,18,9,55,164
315,Thon Maker\makerth01,PF,21,DET,17,1,296,28,78,.359,11,40,.275,17,38,.447,.429,18,27,.667,17,42,59,18,6,17,15,27,85
316,Boban Marjanovic\marjabo01,C,30,TOT,48,11,547,122,199,.613,0,3,.000,122,196,.622,.613,90,120,.750,73,144,217,38,13,24,52,74,334
316,Boban Marjanovic\marjabo01,C,30,LAC,36,9,376,85,140,.607,0,2,.000,85,138,.616,.607,72,95,.758,55,97,152,22,11,17,37,57,242
316,Boban Marjanovic\marjabo01,C,30,PHI,12,2,171,37,59,.627,0,1,.000,37,58,.638,.627,18,25,.720,18,47,65,16,2,7,15,17,92
317,Lauri Markkanen\markkla01,PF,21,CHI,50,49,1639,334,765,.437,118,323,.365,216,442,.489,.514,160,184,.870,68,383,451,75,35,31,81,120,946
318,Jarell Martin\martija01,PF,24,ORL,36,1,283,40,93,.430,19,48,.396,21,45,.467,.532,7,9,.778,10,52,62,15,2,8,11,40,106
319,Frank Mason\masonfr01,PG,24,SAC,35,0,403,61,147,.415,11,53,.208,50,94,.532,.452,36,53,.679,4,34,38,82,16,4,30,29,169
320,Wesley Matthews\matthwe02,SF-SG,32,TOT,62,61,1897,260,640,.406,140,371,.377,120,269,.446,.516,129,159,.811,28,128,156,143,49,16,83,147,789
320,Wesley Matthews\matthwe02,SF,32,DAL,44,44,1312,194,469,.414,100,263,.380,94,206,.456,.520,87,110,.791,20,82,102,100,33,12,58,102,575
320,Wesley Matthews\matthwe02,SG,32,NYK,2,1,54,4,19,.211,2,10,.200,2,9,.222,.263,4,5,.800,1,2,3,5,1,1,2,2,14
320,Wesley Matthews\matthwe02,SG,32,IND,16,16,531,62,152,.408,38,98,.388,24,54,.444,.533,38,44,.864,7,44,51,38,15,3,23,43,200
321,Luc Mbah a Moute\mbahalu01,PF,32,LAC,4,0,61,8,18,.444,2,6,.333,6,12,.500,.500,2,5,.400,2,5,7,2,1,1,2,8,20
322,Tahjere McCall\mccalta01,SG,24,BRK,1,0,8,2,3,.667,0,1,.000,2,2,1.000,.667,0,1,.000,0,1,1,0,0,0,0,2,4
323,Patrick McCaw\mccawpa01,SG,23,TOT,26,1,350,22,55,.400,8,25,.320,14,30,.467,.473,13,15,.867,7,37,44,26,20,2,15,33,65
323,Patrick McCaw\mccawpa01,SG,23,CLE,3,0,53,2,9,.222,1,4,.250,1,5,.200,.278,0,0,,0,3,3,2,2,0,3,1,5
323,Patrick McCaw\mccawpa01,SG,23,TOR,23,1,297,20,46,.435,7,21,.333,13,25,.520,.511,13,15,.867,7,34,41,24,18,2,12,32,60
324,CJ McCollum\mccolcj01,SG,27,POR,68,68,2321,563,1217,.463,165,434,.380,398,783,.508,.530,157,189,.831,60,215,275,198,54,27,104,166,1448
325,T.J. McConnell\mccontj01,PG,26,PHI,66,1,1290,189,359,.526,12,39,.308,177,320,.553,.543,27,34,.794,25,123,148,237,75,14,81,97,417
326,Doug McDermott\mcderdo01,SF,27,IND,67,0,1136,168,346,.486,75,183,.410,93,163,.571,.594,59,70,.843,13,80,93,56,15,7,38,88,470
327,JaVale McGee\mcgeeja01,C,31,LAL,64,51,1368,315,514,.613,1,8,.125,314,506,.621,.614,78,120,.650,150,287,437,38,40,119,86,165,709
328,Rodney McGruder\mcgruro01,SG,27,MIA,63,45,1508,183,450,.407,79,222,.356,104,228,.456,.494,52,70,.743,55,171,226,110,35,11,63,114,497
329,Alfonzo McKinnie\mckinal01,SF,26,GSW,60,4,840,115,240,.479,33,98,.337,82,142,.577,.548,20,36,.556,75,141,216,25,14,13,25,117,283
330,Ben McLemore\mclembe01,SG,25,SAC,19,0,158,25,64,.391,17,41,.415,8,23,.348,.523,8,12,.667,3,14,17,4,6,3,5,22,75
331,Jordan McRae\mcraejo01,SG,27,WAS,20,0,186,34,68,.500,8,15,.533,26,53,.491,.559,15,20,.750,4,18,22,12,7,5,9,12,91
332,Jodie Meeks\meeksjo01,SG,31,TOR,2,0,24,6,13,.462,3,8,.375,3,5,.600,.577,0,0,,0,4,4,1,0,0,0,2,15
333,Salah Mejri\mejrisa01,C,32,DAL,28,4,259,28,58,.483,4,11,.364,24,47,.511,.517,10,13,.769,23,52,75,20,9,11,12,36,70
334,De'Anthony Melton\meltode01,PG,20,PHO,41,27,793,81,218,.372,26,85,.306,55,133,.414,.431,15,18,.833,19,89,108,133,57,18,58,96,203
335,Chimezie Metu\metuch01,PF,21,SAS,29,0,145,19,58,.328,0,2,.000,19,56,.339,.328,13,17,.765,9,27,36,13,6,2,15,14,51
336,Khris Middleton\middlkh01,SF,27,MIL,69,69,2169,436,1003,.435,161,420,.383,275,583,.472,.515,199,237,.840,44,377,421,298,70,6,157,160,1232
337,C.J. Miles\milescj01,SF,31,TOT,53,1,856,112,311,.360,67,203,.330,45,108,.417,.468,48,58,.828,13,82,95,36,26,15,30,79,339
337,C.J. Miles\milescj01,SF,31,TOR,40,1,562,70,206,.340,43,137,.314,27,69,.391,.444,35,44,.795,12,56,68,22,18,10,21,62,218
337,C.J. Miles\milescj01,SF,31,MEM,13,0,294,42,105,.400,24,66,.364,18,39,.462,.514,13,14,.929,1,26,27,14,8,5,9,17,121
338,Darius Miller\milleda01,SF,28,NOP,66,15,1693,182,464,.392,131,354,.370,51,110,.464,.533,53,66,.803,13,110,123,138,39,23,54,163,548
339,Malcolm Miller\millema01,SF,25,TOR,6,0,36,9,18,.500,9,16,.563,0,2,.000,.750,0,0,,0,2,2,1,1,0,0,2,27
340,Patty Mills\millspa02,PG,30,SAS,72,1,1704,250,584,.428,138,347,.398,112,237,.473,.546,83,97,.856,23,140,163,217,45,9,85,118,721
341,Paul Millsap\millspa01,PF,33,DEN,58,53,1554,278,557,.499,47,132,.356,231,425,.544,.541,153,212,.722,125,293,418,113,74,49,75,155,756
342,Shake Milton\miltosh01,SG,22,PHI,13,0,126,20,46,.435,10,25,.400,10,21,.476,.543,4,5,.800,7,13,20,13,4,3,3,14,54
343,Nikola Mirotic\mirotni01,PF,27,TOT,46,25,1245,238,542,.439,116,318,.365,122,224,.545,.546,105,124,.847,60,279,339,55,31,34,48,107,697
343,Nikola Mirotic\mirotni01,PF,27,NOP,32,22,925,182,407,.447,85,231,.368,97,176,.551,.552,85,101,.842,46,218,264,35,21,25,37,86,534
343,Nikola Mirotic\mirotni01,PF,27,MIL,14,3,320,56,135,.415,31,87,.356,25,48,.521,.530,20,23,.870,14,61,75,20,10,9,11,21,163
344,Donovan Mitchell\mitchdo01,SG,22,UTA,67,67,2259,576,1344,.429,161,463,.348,415,881,.471,.488,268,337,.795,52,217,269,276,94,28,196,182,1581
345,Naz Mitrou-Long\mitrona01,SG,25,UTA,10,0,39,2,8,.250,1,6,.167,1,2,.500,.313,0,0,,0,2,2,4,0,0,3,5,5
346,Malik Monk\monkma01,SG,20,CHO,61,0,1061,199,516,.386,92,284,.324,107,232,.461,.475,84,94,.894,13,91,104,103,30,15,75,83,574
347,Greg Monroe\monrogr01,C,28,TOR,38,2,423,74,161,.460,0,4,.000,74,157,.471,.460,35,61,.574,60,96,156,16,13,8,31,61,183
348,E'Twaun Moore\mooreet01,SF,29,NOP,53,36,1463,256,532,.481,76,176,.432,180,356,.506,.553,45,59,.763,35,92,127,102,40,8,59,112,633
349,Eric Moreland\moreler01,PF,27,TOT,4,0,36,3,6,.500,1,1,1.000,2,5,.400,.583,0,0,,3,13,16,4,0,0,3,9,7
349,Eric Moreland\moreler01,PF,27,PHO,1,0,5,0,0,,0,0,,0,0,,,0,0,,0,3,3,0,0,0,0,1,0
349,Eric Moreland\moreler01,PF,27,TOR,3,0,31,3,6,.500,1,1,1.000,2,5,.400,.583,0,0,,3,10,13,4,0,0,3,8,7
350,Jaylen Morris\morrija01,SG,23,MIL,4,0,29,4,10,.400,1,3,.333,3,7,.429,.450,1,2,.500,0,5,5,4,2,0,1,1,10
351,Marcus Morris\morrima03,PF,29,BOS,67,50,1868,345,751,.459,132,346,.382,213,405,.526,.547,127,152,.836,67,345,412,95,38,21,85,163,949
352,Markieff Morris\morrima02,PF,29,TOT,48,16,1119,179,421,.425,61,180,.339,118,241,.490,.498,67,87,.770,50,178,228,70,31,22,49,149,486
352,Markieff Morris\morrima02,PF,29,WAS,34,15,883,143,328,.436,48,144,.333,95,184,.516,.509,57,73,.781,41,133,174,60,25,20,47,117,391
352,Markieff Morris\morrima02,PF,29,OKC,14,1,236,36,93,.387,13,36,.361,23,57,.404,.457,10,14,.714,9,45,54,10,6,2,2,32,95
353,Monte Morris\morrimo01,PG,23,DEN,69,5,1678,290,592,.490,79,188,.420,211,404,.522,.557,50,63,.794,30,147,177,260,63,4,46,85,709
354,Johnathan Motley\motlejo01,PF,23,LAC,17,0,134,31,63,.492,0,3,.000,31,60,.517,.492,22,34,.647,15,25,40,8,4,2,14,22,84
355,Emmanuel Mudiay\mudiaem01,PG,22,NYK,53,36,1402,291,642,.453,60,179,.335,231,463,.499,.500,119,155,.768,28,134,162,198,40,17,122,89,761
356,Jamal Murray\murraja01,PG,21,DEN,63,62,2080,429,994,.432,132,352,.375,297,642,.463,.498,155,183,.847,56,206,262,304,52,20,140,133,1145
357,Dzanan Musa\musadz01,SG,19,BRK,8,0,34,8,20,.400,0,9,.000,8,11,.727,.400,0,2,.000,1,3,4,1,2,0,4,1,16
358,Mike Muscala\muscami01,PF,27,TOT,58,8,1143,119,310,.384,73,223,.327,46,87,.529,.502,66,81,.815,52,161,213,67,19,32,43,122,377
358,Mike Muscala\muscami01,PF,27,PHI,47,6,1041,109,278,.392,68,199,.342,41,79,.519,.514,63,77,.818,51,149,200,62,18,27,43,112,349
358,Mike Muscala\muscami01,PF,27,LAL,11,2,102,10,32,.313,5,24,.208,5,8,.625,.391,3,4,.750,1,12,13,5,1,5,0,10,28
359,Sviatoslav Mykhailiuk\mykhasv01,SF-SG,21,TOT,42,0,440,46,140,.329,29,89,.326,17,51,.333,.432,12,20,.600,9,27,36,37,14,1,21,25,133
359,Sviatoslav Mykhailiuk\mykhasv01,SF,21,LAL,39,0,420,44,132,.333,27,85,.318,17,47,.362,.436,12,20,.600,8,26,34,33,13,1,20,25,127
359,Sviatoslav Mykhailiuk\mykhasv01,SG,21,DET,3,0,20,2,8,.250,2,4,.500,0,4,.000,.375,0,0,,1,1,2,4,1,0,1,0,6
360,Abdel Nader\naderab01,SF,25,OKC,53,1,620,81,186,.435,29,84,.345,52,102,.510,.513,27,35,.771,11,92,103,17,17,11,23,63,218
361,Larry Nance\nancela02,C,26,CLE,57,24,1488,204,391,.522,26,73,.356,178,318,.560,.555,81,116,.698,141,309,450,173,80,36,80,162,515
362,Shabazz Napier\napiesh01,PG,27,BRK,54,2,942,161,414,.389,70,213,.329,91,201,.453,.473,115,138,.833,14,80,94,137,41,16,65,64,507
363,Raul Neto\netora01,PG,26,UTA,30,1,374,60,128,.469,16,49,.327,44,79,.557,.531,19,22,.864,3,45,48,76,12,2,25,38,155
364,Georges Niang\niangge01,PF,25,UTA,49,0,355,56,123,.455,33,79,.418,23,44,.523,.589,11,15,.733,8,55,63,23,7,3,14,38,156
365,Joakim Noah\noahjo01,C,33,MEM,41,1,684,109,209,.522,0,1,.000,109,208,.524,.522,75,105,.714,56,177,233,86,20,31,50,92,293
366,Nerlens Noel\noelne01,C,24,OKC,67,2,947,144,253,.569,0,0,,144,253,.569,.569,49,71,.690,113,182,295,41,61,85,40,148,337
367,Dirk Nowitzki\nowitdi01,PF,40,DAL,40,10,551,84,237,.354,42,140,.300,42,97,.433,.443,30,40,.750,2,92,94,24,7,13,13,58,240
368,Frank Ntilikina\ntilila01,PG,20,NYK,41,16,872,94,275,.342,32,110,.291,62,165,.376,.400,21,28,.750,10,72,82,116,30,14,54,100,241
369,James Nunnally\nunnaja01,SF,28,TOT,15,0,102,12,34,.353,8,25,.320,4,9,.444,.471,4,4,1.000,0,5,5,7,1,0,1,10,36
369,James Nunnally\nunnaja01,SF,28,MIN,13,0,64,9,21,.429,5,13,.385,4,8,.500,.548,4,4,1.000,0,4,4,5,1,0,1,4,27
369,James Nunnally\nunnaja01,SF,28,HOU,2,0,38,3,13,.231,3,12,.250,0,1,.000,.346,0,0,,0,1,1,2,0,0,0,6,9
370,Jusuf Nurkic\nurkiju01,C,24,POR,70,70,1908,401,790,.508,3,29,.103,398,761,.523,.509,273,353,.773,239,487,726,225,69,97,165,243,1078
371,David Nwaba\nwabada01,SG,26,CLE,41,13,793,101,212,.476,22,66,.333,79,146,.541,.528,50,76,.658,34,95,129,45,29,15,22,88,274
372,Royce O'Neale\onealro01,SF,25,UTA,71,12,1398,138,289,.478,58,144,.403,80,145,.552,.578,28,38,.737,20,229,249,107,47,22,58,143,362
373,Kyle O'Quinn\oquinky01,C,28,IND,40,2,339,60,119,.504,1,11,.091,59,108,.546,.508,15,19,.789,27,82,109,47,8,21,28,63,136
374,Semi Ojeleye\ojelese01,PF,24,BOS,49,2,512,55,127,.433,23,73,.315,32,54,.593,.524,21,32,.656,22,53,75,18,9,4,17,39,154
375,Jahlil Okafor\okafoja01,C,23,NOP,51,18,748,166,289,.574,0,2,.000,166,287,.578,.574,51,78,.654,71,153,224,31,13,32,40,85,383
376,Elie Okobo\okoboel01,PG,21,PHO,44,11,782,90,238,.378,29,106,.274,61,132,.462,.439,31,40,.775,8,73,81,109,25,5,56,94,240
377,Josh Okogie\okogijo01,SG,20,MIN,63,41,1447,162,428,.379,53,189,.280,109,239,.456,.440,96,133,.722,38,149,187,73,69,26,59,144,473
378,Victor Oladipo\oladivi01,SG,26,IND,36,36,1147,249,588,.423,74,216,.343,175,372,.470,.486,103,141,.730,21,181,202,186,60,11,82,72,675
379,Kelly Olynyk\olynyke01,PF,27,MIA,68,25,1526,229,488,.469,99,272,.364,130,216,.602,.571,133,164,.811,65,256,321,126,47,27,98,160,690
380,Cedi Osman\osmande01,SF,23,CLE,66,65,2110,314,733,.428,115,323,.356,199,410,.485,.507,121,154,.786,37,280,317,174,49,11,103,162,864
381,Kelly Oubre\oubreke01,SF,23,TOT,69,19,1935,375,842,.445,108,338,.320,267,504,.530,.510,189,244,.775,71,254,325,84,84,59,103,181,1047
381,Kelly Oubre\oubreke01,SF,23,WAS,29,7,755,132,305,.433,41,132,.311,91,173,.526,.500,68,85,.800,24,105,129,20,27,20,30,71,373
381,Kelly Oubre\oubreke01,SF,23,PHO,40,12,1180,243,537,.453,67,206,.325,176,331,.532,.515,121,159,.761,47,149,196,64,57,39,73,110,674
382,Zaza Pachulia\pachuza01,C,34,DET,57,3,775,77,175,.440,0,4,.000,77,171,.450,.440,86,111,.775,92,151,243,78,29,17,47,127,240
383,Jabari Parker\parkeja01,PF,23,TOT,57,17,1541,333,664,.502,57,173,.329,276,491,.562,.544,112,157,.713,66,307,373,138,41,26,140,128,835
383,Jabari Parker\parkeja01,PF,23,CHI,39,17,1042,220,464,.474,37,114,.325,183,350,.523,.514,79,108,.731,41,200,241,84,23,14,84,87,556
383,Jabari Parker\parkeja01,PF,23,WAS,18,0,499,113,200,.565,20,59,.339,93,141,.660,.615,33,49,.673,25,107,132,54,18,12,56,41,279
384,Tony Parker\parketo01,PG,36,CHO,56,0,1003,213,463,.460,13,51,.255,200,412,.485,.474,91,124,.734,14,69,83,207,21,7,75,53,530
385,Chandler Parsons\parsoch01,SF,30,MEM,15,3,260,29,85,.341,14,52,.269,15,33,.455,.424,5,7,.714,3,36,39,22,13,2,14,29,77
386,Patrick Patterson\pattepa01,PF,29,OKC,61,5,854,82,218,.376,46,136,.338,36,82,.439,.482,19,30,.633,41,104,145,31,16,13,21,45,229
387,Justin Patton\pattoju01,C,21,PHI,3,0,21,2,7,.286,0,2,.000,2,5,.400,.286,1,2,.500,2,4,6,3,2,0,0,5,5
388,Chris Paul\paulch01,PG,33,HOU,48,48,1565,245,586,.418,103,290,.355,142,296,.480,.506,158,184,.859,30,191,221,394,92,15,133,128,751
389,Cameron Payne\payneca01,PG,24,TOT,40,13,712,96,223,.430,25,84,.298,71,139,.511,.487,33,41,.805,13,59,72,106,28,9,45,64,250
389,Cameron Payne\payneca01,PG,24,CHI,31,12,536,69,168,.411,16,59,.271,53,109,.486,.458,22,25,.880,10,43,53,83,20,6,34,49,176
389,Cameron Payne\payneca01,PG,24,CLE,9,1,176,27,55,.491,9,25,.360,18,30,.600,.573,11,16,.688,3,16,19,23,8,3,11,15,74
390,Elfrid Payton\paytoel01,PG,24,NOP,34,34,999,144,328,.439,28,79,.354,116,249,.466,.482,46,63,.730,47,138,185,248,36,12,86,71,362
391,Gary Payton\paytoga02,PG,26,WAS,3,0,16,5,8,.625,1,2,.500,4,6,.667,.688,0,0,,1,1,2,4,3,1,1,2,11
392,Theo Pinson\pinsoth01,SG,23,BRK,15,0,188,22,63,.349,11,39,.282,11,24,.458,.437,19,22,.864,2,30,32,19,5,0,15,13,74
393,Mason Plumlee\plumlma01,C,28,DEN,69,16,1421,225,372,.605,2,8,.250,223,364,.613,.608,94,174,.540,142,281,423,196,56,65,109,218,546
394,Miles Plumlee\plumlmi01,C,30,ATL,18,0,173,32,48,.667,0,0,,32,48,.667,.667,16,30,.533,16,23,39,17,6,4,10,14,80
395,Jakob Poeltl\poeltja01,C,23,SAS,67,17,1086,162,254,.638,0,0,,162,254,.638,.638,42,78,.538,153,200,353,85,23,56,46,109,366
396,Quincy Pondexter\pondequ01,SF,30,SAS,47,0,266,27,55,.491,6,18,.333,21,37,.568,.545,30,38,.789,8,36,44,24,9,1,10,23,90
397,Otto Porter\porteot01,SF,25,TOT,56,43,1683,299,643,.465,104,256,.406,195,387,.504,.546,78,96,.813,54,260,314,120,82,31,65,108,780
397,Otto Porter\porteot01,SF,25,WAS,41,28,1191,202,442,.457,65,176,.369,137,266,.515,.531,49,64,.766,40,191,231,80,64,22,40,79,518
397,Otto Porter\porteot01,SF,25,CHI,15,15,492,97,201,.483,39,80,.488,58,121,.479,.580,29,32,.906,14,69,83,40,18,9,25,29,262
398,Bobby Portis\portibo01,PF,23,TOT,40,19,1016,227,500,.454,59,146,.404,168,354,.475,.513,61,80,.763,83,226,309,53,26,16,62,123,574
398,Bobby Portis\portibo01,PF,23,CHI,22,6,531,122,271,.450,27,72,.375,95,199,.477,.500,39,50,.780,46,115,161,29,11,8,29,61,310
398,Bobby Portis\portibo01,PF,23,WAS,18,13,485,105,229,.459,32,74,.432,73,155,.471,.528,22,30,.733,37,111,148,24,15,8,33,62,264
399,Dwight Powell\poweldw01,C,27,DAL,67,12,1380,246,413,.596,34,108,.315,212,305,.695,.637,156,205,.761,109,223,332,86,38,38,57,171,682
400,Norman Powell\powelno01,SG,25,TOR,50,3,930,155,333,.465,49,140,.350,106,193,.549,.539,55,67,.821,14,92,106,77,31,11,55,85,414
401,Alex Poythress\poythal01,PF,25,ATL,21,1,305,40,81,.494,9,23,.391,31,58,.534,.549,18,29,.621,29,47,76,17,4,10,13,47,107
402,Zhou Qi\qizh01,PF,23,HOU,1,0,1,1,1,1.000,0,0,,1,1,1.000,1.000,0,0,,0,0,0,0,0,0,0,0,2
403,Ivan Rabb\rabbiv01,PF,21,MEM,38,9,485,84,140,.600,2,10,.200,82,130,.631,.607,32,45,.711,51,95,146,36,9,10,25,57,202
404,Chasson Randle\randlch01,PG,25,WAS,39,2,581,77,171,.450,36,88,.409,41,83,.494,.556,30,44,.682,8,37,45,72,21,1,37,78,220
405,Julius Randle\randlju01,C,24,NOP,67,43,2046,516,987,.523,58,174,.333,458,813,.563,.552,320,441,.726,145,436,581,210,48,44,184,228,1410
406,J.J. Redick\redicjj01,SG,34,PHI,68,55,2139,398,916,.434,212,538,.394,186,378,.492,.550,200,223,.897,18,147,165,187,28,16,90,116,1208
407,Davon Reed\reedda01,SG,23,IND,8,0,22,2,4,.500,1,1,1.000,1,3,.333,.625,0,0,,1,1,2,2,0,0,1,1,5
408,Cameron Reynolds\reynoca01,SG,23,MIN,8,0,112,9,29,.310,6,19,.316,3,10,.300,.414,2,2,1.000,1,7,8,4,4,1,1,7,26
409,Josh Richardson\richajo01,SG,25,MIA,69,69,2410,406,984,.413,156,433,.360,250,551,.454,.492,189,221,.855,53,203,256,280,73,33,112,191,1157
410,Malachi Richardson\richama01,SG,23,TOR,22,0,103,9,29,.310,8,25,.320,1,4,.250,.448,4,5,.800,2,11,13,0,1,0,8,13,30
411,Austin Rivers\riverau01,PG-SG,26,TOT,67,15,1814,207,507,.408,93,291,.320,114,216,.528,.500,46,88,.523,24,126,150,150,42,21,65,191,553
411,Austin Rivers\riverau01,SG,26,WAS,29,2,683,76,194,.392,33,106,.311,43,88,.489,.477,25,46,.543,11,60,71,58,18,10,36,72,210
411,Austin Rivers\riverau01,PG,26,HOU,38,13,1131,131,313,.419,60,185,.324,71,128,.555,.514,21,42,.500,13,66,79,92,24,11,29,119,343
412,Devin Robinson\robinde01,SF,23,WAS,4,0,32,8,13,.615,0,0,,8,13,.615,.615,3,6,.500,2,5,7,2,3,1,0,2,19
413,Duncan Robinson\robindu01,PF,24,MIA,10,1,77,8,20,.400,6,17,.353,2,3,.667,.550,1,2,.500,0,10,10,1,2,0,1,4,23
414,Glenn Robinson\robingl02,SF,25,DET,41,18,534,64,157,.408,16,56,.286,48,101,.475,.459,29,35,.829,15,41,56,17,12,7,18,40,173
415,Jerome Robinson\robinje01,SG,21,LAC,25,0,228,30,81,.370,14,42,.333,16,39,.410,.457,4,6,.667,3,25,28,9,7,2,4,36,78
416,Mitchell Robinson\robinmi01,C,20,NYK,56,12,1066,156,229,.681,0,0,,156,229,.681,.681,59,104,.567,143,170,313,30,41,136,30,183,371
417,Rajon Rondo\rondora01,PG,32,LAL,37,20,1080,142,337,.421,37,101,.366,105,236,.445,.476,20,30,.667,29,167,196,286,40,6,105,84,341
418,Derrick Rose\rosede01,PG,30,MIN,51,13,1392,363,753,.482,54,146,.370,309,607,.509,.518,137,160,.856,33,107,140,220,31,12,82,57,917
419,Terrence Ross\rosste01,SG,27,ORL,71,0,1867,380,899,.423,177,477,.371,203,422,.481,.521,97,113,.858,23,222,245,111,62,27,80,108,1034
420,Terry Rozier\roziete01,PG,24,BOS,69,11,1581,231,593,.390,108,304,.355,123,289,.426,.481,67,85,.788,30,247,277,206,63,20,60,89,637
421,Ricky Rubio\rubiori01,PG,28,UTA,61,60,1726,261,661,.395,75,238,.315,186,423,.440,.452,169,198,.854,31,191,222,376,84,10,167,163,766
422,D'Angelo Russell\russeda01,PG,22,BRK,72,72,2165,573,1325,.432,202,552,.366,371,773,.480,.509,141,177,.797,41,224,265,494,87,19,214,124,1489
423,Domantas Sabonis\sabondo01,C,22,IND,65,5,1611,359,605,.593,8,15,.533,351,590,.595,.600,196,271,.723,161,437,598,183,45,28,141,213,922
424,Brandon Sampson\sampsbr01,SG,21,CHI,5,0,30,5,8,.625,2,5,.400,3,3,1.000,.750,0,0,,0,4,4,1,0,0,0,3,12
425,Dario Saric\saricda01,PF,24,TOT,70,30,1720,250,580,.431,97,270,.359,153,310,.494,.515,108,125,.864,110,287,397,107,40,7,85,156,705
425,Dario Saric\saricda01,PF,24,PHI,13,13,396,48,132,.364,21,70,.300,27,62,.435,.443,27,30,.900,21,65,86,26,4,3,25,39,144
425,Dario Saric\saricda01,PF,24,MIN,57,17,1324,202,448,.451,76,200,.380,126,248,.508,.536,81,95,.853,89,222,311,81,36,4,60,117,561
426,Tomas Satoransky\satorto01,SG,27,WAS,70,44,1846,223,454,.491,56,139,.403,167,315,.530,.553,103,125,.824,69,172,241,335,72,13,99,156,605
427,Dennis Schroder\schrode01,PG,25,OKC,69,13,2005,399,977,.408,103,310,.332,296,667,.444,.461,160,198,.808,32,213,245,288,57,10,154,162,1061
428,Mike Scott\scottmi01,PF,30,TOT,70,0,1166,138,358,.385,84,216,.389,54,142,.380,.503,20,31,.645,39,196,235,60,26,12,43,136,380
428,Mike Scott\scottmi01,PF,30,LAC,52,0,748,92,230,.400,52,133,.391,40,97,.412,.513,12,18,.667,24,150,174,44,17,8,27,88,248
428,Mike Scott\scottmi01,PF,30,PHI,18,0,418,46,128,.359,32,83,.386,14,45,.311,.484,8,13,.615,15,46,61,16,9,4,16,48,132
429,Thabo Sefolosha\sefolth01,SF,34,UTA,39,0,407,47,98,.480,23,52,.442,24,46,.522,.597,10,16,.625,6,84,90,16,30,5,17,29,127
430,Wayne Selden\seldewa01,SG,24,TOT,66,5,1210,160,390,.410,48,145,.331,112,245,.457,.472,64,85,.753,29,104,133,93,27,13,63,115,432
430,Wayne Selden\seldewa01,SG,24,MEM,32,0,455,65,161,.404,20,63,.317,45,98,.459,.466,22,29,.759,16,28,44,36,10,6,23,48,172
430,Wayne Selden\seldewa01,SG,24,CHI,34,5,755,95,229,.415,28,82,.341,67,147,.456,.476,42,56,.750,13,76,89,57,17,7,40,67,260
431,Collin Sexton\sextoco01,PG,20,CLE,72,62,2238,437,1033,.423,99,237,.418,338,796,.425,.471,190,227,.837,50,163,213,208,38,6,162,165,1163
432,Landry Shamet\shamela01,SG-PG,21,TOT,70,18,1562,211,486,.434,146,348,.420,65,138,.471,.584,67,80,.838,17,92,109,92,35,9,39,138,635
432,Landry Shamet\shamela01,SG,21,PHI,54,4,1108,153,347,.441,99,245,.404,54,102,.529,.584,44,54,.815,14,64,78,59,24,8,26,106,449
432,Landry Shamet\shamela01,PG,21,LAC,16,14,454,58,139,.417,47,103,.456,11,36,.306,.586,23,26,.885,3,28,31,33,11,1,13,32,186
433,Iman Shumpert\shumpim01,SG,28,TOT,54,41,1316,151,405,.373,85,243,.350,66,162,.407,.478,34,41,.829,23,136,159,107,56,22,44,117,421
433,Iman Shumpert\shumpim01,SG,28,SAC,42,40,1099,133,348,.382,74,202,.366,59,146,.404,.489,34,41,.829,19,110,129,91,47,20,38,92,374
433,Iman Shumpert\shumpim01,SG,28,HOU,12,1,217,18,57,.316,11,41,.268,7,16,.438,.412,0,0,,4,26,30,16,9,2,6,25,47
434,Pascal Siakam\siakapa01,PF,24,TOR,71,70,2277,454,833,.545,64,184,.348,390,649,.601,.583,209,270,.774,112,383,495,219,68,49,130,214,1181
435,Jordan Sibert\siberjo01,SG,26,ATL,1,0,4,1,1,1.000,1,1,1.000,0,0,,1.500,0,0,,0,0,0,0,0,0,0,0,3
436,Ben Simmons\simmobe01,PG,22,PHI,71,71,2451,489,860,.569,0,4,.000,489,856,.571,.569,234,388,.603,157,484,641,553,97,52,249,182,1212
437,Jonathon Simmons\simmojo02,SG-SF,29,TOT,52,9,991,118,323,.365,23,95,.242,95,228,.417,.401,65,87,.747,25,90,115,112,26,14,64,87,324
437,Jonathon Simmons\simmojo02,SG,29,ORL,41,9,845,104,286,.364,19,83,.229,85,203,.419,.397,56,72,.778,23,77,100,95,18,14,56,68,283
437,Jonathon Simmons\simmojo02,SF,29,PHI,11,0,146,14,37,.378,4,12,.333,10,25,.400,.432,9,15,.600,2,13,15,17,8,0,8,19,41
438,Kobi Simmons\simmoko01,PG,21,CLE,1,0,2,0,0,,0,0,,0,0,,,0,0,,0,0,0,0,0,0,0,0,0
439,Anfernee Simons\simonan01,SG,19,POR,14,0,73,9,30,.300,1,12,.083,8,18,.444,.317,3,8,.375,0,7,7,4,0,0,8,6,22
440,Marcus Smart\smartma01,SG,24,BOS,71,51,1954,206,487,.423,111,303,.366,95,184,.516,.537,93,116,.802,51,158,209,289,126,26,108,180,616
441,Dennis Smith\smithde03,PG,21,TOT,49,49,1409,254,590,.431,61,187,.326,193,403,.479,.482,94,148,.635,29,114,143,240,64,20,141,126,663
441,Dennis Smith\smithde03,PG,21,DAL,32,32,908,157,357,.440,43,125,.344,114,232,.491,.500,57,82,.695,18,79,97,138,40,11,100,82,414
441,Dennis Smith\smithde03,PG,21,NYK,17,17,501,97,233,.416,18,62,.290,79,171,.462,.455,37,66,.561,11,35,46,102,24,9,41,44,249
442,Ish Smith\smithis01,PG,30,DET,44,0,979,154,370,.416,38,112,.339,116,258,.450,.468,34,45,.756,17,94,111,156,24,10,49,85,380
443,J.R. Smith\smithjr01,SG,33,CLE,11,4,222,27,79,.342,12,39,.308,15,40,.375,.418,8,10,.800,0,18,18,21,11,3,11,19,74
444,Jason Smith\smithja02,C-PF,32,TOT,20,1,190,21,59,.356,9,26,.346,12,33,.364,.432,14,16,.875,16,36,52,14,3,7,13,30,65
444,Jason Smith\smithja02,C,32,WAS,12,1,130,15,37,.405,4,10,.400,11,27,.407,.459,10,12,.833,11,26,37,12,1,5,7,21,44
444,Jason Smith\smithja02,PF,32,MIL,6,0,40,4,13,.308,3,9,.333,1,4,.250,.423,2,2,1.000,3,8,11,1,2,2,5,6,13
444,Jason Smith\smithja02,PF,32,NOP,2,0,20,2,9,.222,2,7,.286,0,2,.000,.333,2,2,1.000,2,2,4,1,0,0,1,3,8
445,Tony Snell\snellto01,SG,27,MIL,72,10,1263,156,350,.446,77,197,.391,79,153,.516,.556,33,38,.868,28,122,150,66,24,17,22,86,422
446,Ray Spalding\spaldra01,PF,21,TOT,4,0,23,5,7,.714,0,1,.000,5,6,.833,.714,0,1,.000,1,4,5,2,0,3,2,5,10
446,Ray Spalding\spaldra01,PF,21,DAL,1,0,1,0,0,,0,0,,0,0,,,0,0,,0,0,0,0,0,0,0,0,0
446,Ray Spalding\spaldra01,PF,21,PHO,3,0,22,5,7,.714,0,1,.000,5,6,.833,.714,0,1,.000,1,4,5,2,0,3,2,5,10
447,Omari Spellman\spellom01,PF,21,ATL,46,11,805,98,244,.402,44,128,.344,54,116,.466,.492,32,45,.711,72,122,194,47,26,25,31,67,272
448,Nik Stauskas\stausni01,SG,25,TOT,59,0,910,122,303,.403,61,171,.357,61,132,.462,.503,54,60,.900,17,99,116,77,19,5,48,47,359
448,Nik Stauskas\stausni01,SG,25,POR,44,0,673,96,229,.419,43,125,.344,53,104,.510,.513,32,36,.889,10,70,80,62,14,4,40,31,267
448,Nik Stauskas\stausni01,SG,25,CLE,15,0,237,26,74,.351,18,46,.391,8,28,.286,.473,22,24,.917,7,29,36,15,5,1,8,16,92
449,D.J. Stephens\stephdj01,SG,28,MEM,1,0,7,1,2,.500,0,0,,1,2,.500,.500,0,0,,0,0,0,0,1,0,1,0,2
450,Lance Stephenson\stephla01,SG,28,LAL,61,0,952,165,379,.435,64,169,.379,101,210,.481,.520,44,65,.677,27,149,176,120,36,6,75,99,438
451,Edmond Sumner\sumneed01,PG,23,IND,19,2,170,16,49,.327,4,20,.200,12,29,.414,.367,5,12,.417,7,12,19,8,9,5,8,21,41
452,Caleb Swanigan\swanica01,PF,21,POR,18,0,145,14,44,.318,1,5,.200,13,39,.333,.330,6,7,.857,13,39,52,7,4,0,16,22,35
453,Jayson Tatum\tatumja01,SF,20,BOS,71,71,2217,423,934,.453,101,280,.361,322,654,.492,.507,186,214,.869,64,374,438,143,77,54,110,155,1133
454,Jeff Teague\teaguje01,PG,30,MIN,42,41,1264,176,416,.423,35,105,.333,141,311,.453,.465,123,153,.804,16,90,106,343,43,18,97,90,510
455,Garrett Temple\templga01,SG,32,TOT,65,51,1818,187,444,.421,78,235,.332,109,209,.522,.509,72,97,.742,22,166,188,88,63,29,61,180,524
455,Garrett Temple\templga01,SG,32,MEM,49,49,1530,166,387,.429,74,210,.352,92,177,.520,.525,57,76,.750,18,134,152,69,50,25,54,134,463
455,Garrett Temple\templga01,SG,32,LAC,16,2,288,21,57,.368,4,25,.160,17,32,.531,.404,15,21,.714,4,32,36,19,13,4,7,46,61
456,Milos Teodosic\teodomi01,PG,31,LAC,15,0,150,17,40,.425,10,27,.370,7,13,.538,.550,4,7,.571,3,13,16,32,3,1,21,27,48
457,Jared Terrell\terreja01,SG,23,MIN,10,0,75,8,27,.296,4,12,.333,4,15,.267,.370,1,2,.500,1,3,4,7,3,1,8,8,21
458,Emanuel Terry\terryem01,PF,22,TOT,3,0,23,4,7,.571,0,0,,4,7,.571,.571,2,4,.500,3,4,7,2,3,0,2,4,10
458,Emanuel Terry\terryem01,PF,22,PHO,2,0,20,4,6,.667,0,0,,4,6,.667,.667,1,2,.500,2,4,6,1,3,0,2,4,9
458,Emanuel Terry\terryem01,PF,22,MIA,1,0,3,0,1,.000,0,0,,0,1,.000,.000,1,2,.500,1,0,1,1,0,0,0,0,1
459,Daniel Theis\theisda01,C,26,BOS,57,2,791,128,233,.549,25,60,.417,103,173,.595,.603,52,70,.743,76,124,200,61,19,35,31,139,333
460,Isaiah Thomas\thomais02,PG,29,DEN,10,0,147,28,77,.364,9,34,.265,19,43,.442,.422,12,19,.632,5,7,12,17,3,1,17,14,77
461,Khyri Thomas\thomakh01,SG,22,DET,23,0,188,22,65,.338,10,35,.286,12,30,.400,.415,7,11,.636,4,16,20,8,7,5,4,21,61
462,Lance Thomas\thomala01,PF,30,NYK,39,16,629,63,160,.394,18,65,.277,45,95,.474,.450,22,29,.759,18,76,94,21,16,6,20,72,166
463,Klay Thompson\thompkl01,SG,28,GSW,67,67,2312,585,1244,.470,214,530,.404,371,714,.520,.556,123,151,.815,35,234,269,163,79,43,105,141,1507
464,Tristan Thompson\thomptr01,C,27,CLE,36,35,1055,176,332,.530,0,0,,176,332,.530,.530,56,86,.651,156,239,395,75,28,16,50,82,408
465,Sindarius Thornwell\thornsi01,SG,24,LAC,54,1,270,16,48,.333,3,15,.200,13,33,.394,.365,18,26,.692,5,34,39,15,13,4,18,37,53
466,Anthony Tolliver\tollian01,PF,33,MIN,54,0,859,80,205,.390,64,171,.374,16,34,.471,.546,39,48,.813,12,125,137,35,14,14,29,73,263
467,Karl-Anthony Towns\townska01,C,23,MIN,68,68,2250,609,1162,.524,132,322,.410,477,840,.568,.581,323,388,.832,238,600,838,225,60,114,203,261,1673
468,Gary Trent\trentga02,SG,20,POR,11,0,48,6,22,.273,3,10,.300,3,12,.250,.341,1,4,.250,0,6,6,1,0,1,2,2,16
469,Allonzo Trier\trieral01,SG,23,NYK,64,3,1459,232,518,.448,52,132,.394,180,386,.466,.498,179,223,.803,31,166,197,119,28,14,116,117,695
470,P.J. Tucker\tuckepj01,PF,33,HOU,72,72,2512,187,465,.402,130,341,.381,57,124,.460,.542,37,55,.673,109,322,431,87,121,33,58,225,541
471,Evan Turner\turneev01,PG,30,POR,63,2,1415,181,400,.453,7,46,.152,174,354,.492,.461,62,89,.697,33,248,281,234,29,15,101,102,431
472,Myles Turner\turnemy01,C,22,IND,65,65,1862,337,692,.487,65,170,.382,272,522,.521,.534,126,174,.724,86,369,455,106,54,181,94,175,865
473,Ekpe Udoh\udohek01,C,31,UTA,41,0,216,33,48,.688,0,0,,33,48,.688,.688,11,17,.647,17,33,50,15,5,19,10,25,77
474,Tyler Ulis\ulisty01,PG,23,CHI,1,0,1,0,0,,0,0,,0,0,,,0,0,,0,0,0,0,0,0,0,0,0
475,Jonas Valanciunas\valanjo01,C,26,TOT,43,21,905,248,431,.575,12,42,.286,236,389,.607,.589,124,153,.810,83,244,327,55,16,39,70,122,632
475,Jonas Valanciunas\valanjo01,C,26,TOR,30,10,564,149,259,.575,9,30,.300,140,229,.611,.593,77,94,.819,54,162,216,29,13,23,39,82,384
475,Jonas Valanciunas\valanjo01,C,26,MEM,13,11,341,99,172,.576,3,12,.250,96,160,.600,.584,47,59,.797,29,82,111,26,3,16,31,40,248
476,Jarred Vanderbilt\vandeja01,PF,19,DEN,10,0,24,2,7,.286,0,1,.000,2,6,.333,.286,2,5,.400,3,10,13,2,2,1,2,1,6
477,Fred VanVleet\vanvlfr01,PG,24,TOR,54,24,1469,208,504,.413,94,249,.378,114,255,.447,.506,81,97,.835,20,121,141,256,48,13,71,97,591
478,Noah Vonleh\vonleno01,PF,23,NYK,68,57,1722,207,440,.470,46,137,.336,161,303,.531,.523,111,156,.712,113,415,528,129,46,51,88,174,571
479,Nikola Vucevic\vucevni01,C,28,ORL,71,71,2219,618,1189,.520,74,198,.374,544,991,.549,.551,155,197,.787,199,667,866,275,73,83,140,136,1465
480,Dwyane Wade\wadedw01,SG,37,MIA,61,0,1558,337,774,.435,66,203,.325,271,571,.475,.478,128,188,.681,53,172,225,249,47,34,139,96,868
481,Moritz Wagner\wagnemo01,C,21,LAL,32,1,278,45,109,.413,17,55,.309,28,54,.519,.491,22,30,.733,13,43,56,18,9,6,24,32,129
482,Dion Waiters\waitedi01,SG,27,MIA,33,19,810,131,319,.411,68,187,.364,63,132,.477,.517,16,35,.457,6,88,94,93,23,5,52,45,346
483,Kemba Walker\walkeke02,PG,28,CHO,70,70,2437,609,1422,.428,226,633,.357,383,789,.485,.508,300,360,.833,43,255,298,399,90,31,184,118,1744
484,Lonnie Walker\walkelo01,SG,20,SAS,8,0,64,5,24,.208,2,6,.333,3,18,.167,.250,4,4,1.000,0,11,11,3,4,1,4,4,16
485,John Wall\walljo01,PG,28,WAS,32,32,1104,245,552,.444,51,169,.302,194,383,.507,.490,122,175,.697,15,101,116,279,49,29,121,71,663
486,Tyrone Wallace\wallaty01,PG,24,LAC,54,0,551,79,192,.411,4,16,.250,75,176,.426,.422,26,51,.510,20,69,89,36,19,7,29,70,188
487,Taurean Waller-Prince\princta02,SF,24,ATL,48,40,1337,226,510,.443,105,270,.389,121,240,.504,.546,79,95,.832,21,156,177,101,46,17,90,127,636
488,Brad Wanamaker\wanambr01,PG,29,BOS,30,0,262,35,79,.443,16,32,.500,19,47,.404,.544,16,17,.941,3,27,30,39,9,1,14,22,102
489,T.J. Warren\warretj01,SF,25,PHO,43,36,1360,297,611,.486,77,180,.428,220,431,.510,.549,101,124,.815,31,143,174,64,51,29,52,119,772
490,Julian Washburn\washbju01,SF,27,MEM,7,2,110,3,19,.158,1,8,.125,2,11,.182,.184,3,4,.750,4,16,20,3,4,0,3,5,10
491,Yuta Watanabe\watanyu01,SG,24,MEM,10,0,98,10,28,.357,2,9,.222,8,19,.421,.393,7,10,.700,1,18,19,4,2,1,4,3,29
492,Thomas Welsh\welshth01,C,22,DEN,11,0,36,7,13,.538,3,7,.429,4,6,.667,.654,1,2,.500,0,4,4,5,0,0,1,3,18
493,Russell Westbrook\westbru01,PG,30,OKC,63,63,2262,550,1281,.429,100,347,.288,450,934,.482,.468,262,402,.652,90,608,698,654,126,30,295,220,1462
494,Derrick White\whitede01,PG,24,SAS,57,45,1462,223,457,.488,41,118,.347,182,339,.537,.533,78,104,.750,28,176,204,223,60,38,82,122,565
495,Okaro White\whiteok01,PF,26,WAS,3,0,6,0,2,.000,0,2,.000,0,0,,.000,0,0,,1,1,2,0,0,0,0,0,0
496,Hassan Whiteside\whiteha01,C,29,MIA,62,53,1502,336,611,.550,2,16,.125,334,595,.561,.552,100,219,.457,234,497,731,53,41,121,87,170,774
497,Andrew Wiggins\wiggian01,SF,23,MIN,62,62,2156,406,1019,.398,97,295,.329,309,724,.427,.446,177,254,.697,70,230,300,147,62,42,110,124,1086
498,Alan Williams\willial03,PF,26,BRK,4,0,22,6,10,.600,0,1,.000,6,9,.667,.600,2,4,.500,4,13,17,3,1,0,1,2,14
499,C.J. Williams\willicj01,SG,28,MIN,12,0,90,12,26,.462,2,11,.182,10,15,.667,.500,0,0,,1,4,5,11,3,0,4,13,26
500,Johnathan Williams\willijo04,C,23,LAL,14,0,189,30,53,.566,0,1,.000,30,52,.577,.566,8,18,.444,22,23,45,6,2,5,10,38,68
501,Kenrich Williams\willike04,SF,24,NOP,38,21,845,87,223,.390,41,121,.339,46,102,.451,.482,11,17,.647,43,135,178,56,32,13,27,80,226
502,Lou Williams\willilo02,SG,32,LAC,66,0,1749,431,1013,.425,91,259,.351,340,754,.451,.470,386,439,.879,35,160,195,349,50,8,157,71,1339
503,Marvin Williams\willima02,PF,32,CHO,68,68,1954,252,600,.420,131,353,.371,121,247,.490,.529,62,82,.756,72,310,382,86,60,54,43,146,697
504,Robert Williams\williro04,C,21,BOS,28,0,232,32,43,.744,0,0,,32,43,.744,.744,9,14,.643,23,39,62,5,8,33,9,29,73
505,Troy Williams\willitr02,SF,24,SAC,18,0,286,40,87,.460,14,41,.341,26,46,.565,.540,9,15,.600,9,46,55,10,10,8,8,34,103
506,D.J. Wilson\wilsodj01,PF,22,MIL,38,0,661,74,182,.407,32,93,.344,42,89,.472,.495,15,32,.469,35,127,162,36,15,19,24,67,195
507,Justise Winslow\winslju01,PF,22,MIA,61,48,1814,301,690,.436,89,234,.380,212,456,.465,.501,83,132,.629,60,272,332,263,65,17,130,159,774
508,Christian Wood\woodch01,PF,23,MIL,13,0,62,12,25,.480,3,5,.600,9,20,.450,.540,10,15,.667,4,16,20,2,0,0,3,3,37
509,Delon Wright\wrighde01,PG,26,TOT,64,5,1326,183,431,.425,38,130,.292,145,301,.482,.469,86,102,.843,52,140,192,164,63,23,57,81,490
509,Delon Wright\wrighde01,PG,26,TOR,49,2,897,127,293,.433,30,90,.333,97,203,.478,.485,53,61,.869,39,86,125,110,46,15,37,53,337
509,Delon Wright\wrighde01,PG,26,MEM,15,3,429,56,138,.406,8,40,.200,48,98,.490,.435,33,41,.805,13,54,67,54,17,8,20,28,153
510,Guerschon Yabusele\yabusgu01,PF,23,BOS,34,0,184,26,60,.433,5,21,.238,21,39,.538,.475,13,18,.722,18,22,40,12,7,7,12,28,70
511,Nick Young\youngni01,SG,33,DEN,4,0,37,3,9,.333,3,8,.375,0,1,.000,.500,0,0,,0,1,1,2,0,1,2,4,9
512,Thaddeus Young\youngth01,PF,30,IND,72,72,2219,387,745,.519,45,128,.352,342,617,.554,.550,74,116,.638,173,294,467,175,114,34,105,178,893
513,Trae Young\youngtr01,PG,20,ATL,72,72,2214,448,1078,.416,139,414,.336,309,664,.465,.480,295,358,.824,53,205,258,561,61,14,282,123,1330
514,Cody Zeller\zelleco01,C,26,CHO,49,47,1243,190,345,.551,6,22,.273,184,323,.570,.559,111,141,.787,110,223,333,102,38,41,62,164,497
515,Tyler Zeller\zellety01,C,29,ATL,2,0,11,0,2,.000,0,1,.000,0,1,.000,.000,0,0,,2,4,6,1,0,0,0,4,0
516,Ante Zizic\zizican01,C,22,CLE,52,22,962,157,291,.540,0,0,,157,291,.540,.540,80,112,.714,92,190,282,42,13,19,51,102,394
517,Ivica Zubac\zubaciv01,C,21,TOT,49,28,836,170,317,.536,0,0,,170,317,.536,.536,87,109,.798,97,191,288,53,8,40,58,116,427
517,Ivica Zubac\zubaciv01,C,21,LAL,33,12,516,112,193,.580,0,0,,112,193,.580,.580,57,66,.864,54,108,162,25,4,27,33,73,281
517,Ivica Zubac\zubaciv01,C,21,LAC,16,16,320,58,124,.468,0,0,,58,124,.468,.468,30,43,.698,43,83,126,28,4,13,25,43,146